,CBSA,Mode,Year,Mechanical_Failures,Other_Failures,Total_Failures
0,10180,Bus,2002,1,29,30
1,10180,Bus,2003,10,23,33
2,10180,Bus,2004,7,22,29
3,10180,Bus,2005,9,23,32
4,10180,Bus,2006,12,43,55
5,10180,Bus,2007,9,25,34
6,10180,Bus,2012,0,0,0
7,10180,Bus,2013,0,0,0
8,10180,Bus,2014,0,0,0
9,10180,Bus,2015,0,0,0
10,10180,Bus,2016,0,0,0
11,10180,Bus,2017,0,0,0
12,10180,Bus,2018,0,0,0
13,10420,Bus,2002,76,1279,1355
14,10420,Bus,2003,19,1409,1428
15,10420,Bus,2004,67,1254,1321
16,10420,Bus,2005,169,2369,2538
17,10420,Bus,2006,166,2236,2402
18,10420,Bus,2007,144,1230,1374
19,10420,Bus,2012,128,878,1006
20,10420,Bus,2013,1061,53,1114
21,10420,Bus,2014,1014,56,1070
22,10420,Bus,2015,893,60,953
23,10420,Bus,2016,788,41,829
24,10420,Bus,2017,232,519,751
25,10420,Bus,2018,195,644,839
26,10500,Bus,2002,107,35,142
27,10500,Bus,2003,77,45,122
28,10500,Bus,2004,72,23,95
29,10500,Bus,2005,68,24,92
30,10500,Bus,2006,59,21,80
31,10500,Bus,2007,51,11,62
32,10500,Bus,2012,40,15,55
33,10500,Bus,2013,45,6,51
34,10500,Bus,2014,69,32,101
35,10500,Bus,2015,33,232,265
36,10500,Bus,2016,35,291,326
37,10500,Bus,2017,58,349,407
38,10500,Bus,2018,70,273,343
39,10580,Bus,2002,1016,2466,3482
40,10580,Bus,2003,1095,2247,3342
41,10580,Bus,2004,12,18,30
42,10580,Bus,2005,12,18,30
43,10580,Bus,2006,353,139,492
44,10580,Bus,2007,176,293,469
45,10580,Bus,2012,223,442,665
46,10580,Bus,2013,289,107,396
47,10580,Bus,2014,441,15,456
48,10580,Bus,2015,428,1559,1987
49,10580,Bus,2016,358,1236,1594
50,10580,Bus,2017,454,1234,1688
51,10580,Bus,2018,517,1156,1673
52,10740,Bus,2002,1368,813,2181
53,10740,Bus,2003,718,1541,2259
54,10740,Bus,2004,45,314,359
55,10740,Bus,2005,129,73,202
56,10740,Bus,2006,879,1644,2523
57,10740,Bus,2007,882,1299,2181
58,10740,Bus,2012,255,420,675
59,10740,Bus,2013,258,409,667
60,10740,Bus,2014,183,321,504
61,10740,Bus,2015,161,338,499
62,10740,Bus,2016,161,321,482
63,10740,Bus,2017,234,120,354
64,10740,Bus,2018,166,134,300
65,10740,Rail,2002,0,0,0
66,10740,Rail,2003,0,0,0
67,10740,Rail,2004,0,0,0
68,10740,Rail,2005,0,0,0
69,10740,Rail,2006,0,0,0
70,10740,Rail,2007,0,0,0
71,10740,Rail,2012,17,3,20
72,10740,Rail,2013,8,7,15
73,10740,Rail,2014,9,6,15
74,10740,Rail,2015,14,10,24
75,10740,Rail,2016,20,2,22
76,10740,Rail,2017,13,4,17
77,10740,Rail,2018,13,8,21
78,10780,Bus,2002,9,64,73
79,10780,Bus,2003,9,73,82
80,10780,Bus,2004,11,105,116
81,10780,Bus,2005,28,102,130
82,10780,Bus,2006,41,107,148
83,10780,Bus,2007,53,56,109
84,10780,Bus,2012,0,0,0
85,10780,Bus,2013,0,0,0
86,10780,Bus,2014,0,0,0
87,10780,Bus,2015,0,0,0
88,10780,Bus,2016,0,0,0
89,10780,Bus,2017,0,0,0
90,10780,Bus,2018,0,0,0
91,10900,Bus,2002,174,136,310
92,10900,Bus,2003,173,136,309
93,10900,Bus,2004,221,153,374
94,10900,Bus,2005,202,141,343
95,10900,Bus,2006,50,417,467
96,10900,Bus,2007,37,410,447
97,10900,Bus,2012,22,418,440
98,10900,Bus,2013,20,364,384
99,10900,Bus,2014,24,416,440
100,10900,Bus,2015,28,432,460
101,10900,Bus,2016,32,456,488
102,10900,Bus,2017,46,458,504
103,10900,Bus,2018,71,424,495
104,11020,Bus,2002,147,62,209
105,11020,Bus,2003,172,62,234
106,11020,Bus,2004,176,77,253
107,11020,Bus,2005,168,98,266
108,11020,Bus,2006,127,103,230
109,11020,Bus,2007,110,71,181
110,11020,Bus,2012,40,78,118
111,11020,Bus,2013,54,36,90
112,11020,Bus,2014,43,41,84
113,11020,Bus,2015,47,32,79
114,11020,Bus,2016,23,30,53
115,11020,Bus,2017,40,36,76
116,11020,Bus,2018,63,47,110
117,11100,Bus,2002,102,126,228
118,11100,Bus,2003,23,254,277
119,11100,Bus,2004,52,195,247
120,11100,Bus,2005,40,202,242
121,11100,Bus,2006,12,309,321
122,11100,Bus,2007,5,197,202
123,11100,Bus,2012,16,114,130
124,11100,Bus,2013,14,62,76
125,11100,Bus,2014,14,81,95
126,11100,Bus,2015,0,0,0
127,11100,Bus,2016,0,0,0
128,11100,Bus,2017,0,0,0
129,11100,Bus,2018,0,0,0
130,11180,Bus,2002,26,145,171
131,11180,Bus,2003,38,170,208
132,11180,Bus,2004,35,145,180
133,11180,Bus,2005,49,157,206
134,11180,Bus,2006,41,163,204
135,11180,Bus,2007,38,185,223
136,11180,Bus,2012,41,159,200
137,11180,Bus,2013,44,126,170
138,11180,Bus,2014,34,152,186
139,11180,Bus,2015,50,156,206
140,11180,Bus,2016,43,174,217
141,11180,Bus,2017,44,234,278
142,11180,Bus,2018,35,237,272
143,11260,Bus,2002,48,29,77
144,11260,Bus,2003,84,39,123
145,11260,Bus,2004,103,64,167
146,11260,Bus,2005,165,59,224
147,11260,Bus,2006,94,68,162
148,11260,Bus,2007,283,341,624
149,11260,Bus,2012,150,467,617
150,11260,Bus,2013,67,557,624
151,11260,Bus,2014,277,318,595
152,11260,Bus,2015,465,271,736
153,11260,Bus,2016,518,312,830
154,11260,Bus,2017,371,363,734
155,11260,Bus,2018,170,523,693
156,11300,Bus,2002,1,2,3
157,11300,Bus,2003,0,0,0
158,11300,Bus,2004,24,31,55
159,11300,Bus,2005,18,71,89
160,11300,Bus,2006,49,27,76
161,11300,Bus,2007,28,51,79
162,11300,Bus,2012,0,0,0
163,11300,Bus,2013,0,0,0
164,11300,Bus,2014,0,0,0
165,11300,Bus,2015,0,0,0
166,11300,Bus,2016,0,0,0
167,11300,Bus,2017,0,0,0
168,11300,Bus,2018,0,0,0
169,11460,Bus,2002,663,241,904
170,11460,Bus,2003,587,407,994
171,11460,Bus,2004,465,356,821
172,11460,Bus,2005,457,360,817
173,11460,Bus,2006,405,452,857
174,11460,Bus,2007,450,326,776
175,11460,Bus,2012,275,370,645
176,11460,Bus,2013,323,462,785
177,11460,Bus,2014,269,389,658
178,11460,Bus,2015,248,389,637
179,11460,Bus,2016,171,297,468
180,11460,Bus,2017,205,341,546
181,11460,Bus,2018,174,311,485
182,11540,Bus,2002,4,24,28
183,11540,Bus,2003,29,101,130
184,11540,Bus,2004,35,129,164
185,11540,Bus,2005,33,101,134
186,11540,Bus,2006,21,48,69
187,11540,Bus,2007,29,78,107
188,11540,Bus,2012,29,149,178
189,11540,Bus,2013,26,148,174
190,11540,Bus,2014,44,155,199
191,11540,Bus,2015,29,93,122
192,11540,Bus,2016,38,127,165
193,11540,Bus,2017,44,138,182
194,11540,Bus,2018,35,157,192
195,11700,Bus,2002,11,38,49
196,11700,Bus,2003,2,57,59
197,11700,Bus,2004,3,70,73
198,11700,Bus,2005,8,100,108
199,11700,Bus,2006,6,96,102
200,11700,Bus,2007,18,105,123
201,11700,Bus,2012,63,460,523
202,11700,Bus,2013,57,440,497
203,11700,Bus,2014,88,428,516
204,11700,Bus,2015,48,349,397
205,11700,Bus,2016,33,354,387
206,11700,Bus,2017,15,256,271
207,11700,Bus,2018,24,367,391
208,12020,Bus,2002,51,21,72
209,12020,Bus,2003,67,87,154
210,12020,Bus,2004,102,3,105
211,12020,Bus,2005,110,84,194
212,12020,Bus,2006,25,108,133
213,12020,Bus,2007,20,103,123
214,12020,Bus,2012,53,619,672
215,12020,Bus,2013,28,598,626
216,12020,Bus,2014,26,564,590
217,12020,Bus,2015,36,588,624
218,12020,Bus,2016,35,282,317
219,12020,Bus,2017,106,221,327
220,12020,Bus,2018,105,259,364
221,12060,Bus,2002,10544,504,11048
222,12060,Bus,2003,10030,519,10549
223,12060,Bus,2004,8215,570,8785
224,12060,Bus,2005,5755,1181,6936
225,12060,Bus,2006,5846,1299,7145
226,12060,Bus,2007,8304,2200,10504
227,12060,Bus,2012,6277,3149,9426
228,12060,Bus,2013,7317,3272,10589
229,12060,Bus,2014,7862,2671,10533
230,12060,Bus,2015,5526,2118,7644
231,12060,Bus,2016,5070,1694,6764
232,12060,Bus,2017,7394,2100,9494
233,12060,Bus,2018,8418,3511,11929
234,12060,Rail,2002,1130,392,1522
235,12060,Rail,2003,1107,364,1471
236,12060,Rail,2004,10072,892,10964
237,12060,Rail,2005,13476,1278,14754
238,12060,Rail,2006,13425,1150,14575
239,12060,Rail,2007,1964,98,2062
240,12060,Rail,2012,736,182,918
241,12060,Rail,2013,768,146,914
242,12060,Rail,2014,822,160,982
243,12060,Rail,2015,743,232,975
244,12060,Rail,2016,797,250,1047
245,12060,Rail,2017,788,168,956
246,12060,Rail,2018,798,179,977
247,12220,Bus,2002,181,75,256
248,12220,Bus,2003,210,108,318
249,12220,Bus,2004,219,237,456
250,12220,Bus,2005,165,206,371
251,12220,Bus,2006,132,232,364
252,12220,Bus,2007,143,211,354
253,12220,Bus,2012,0,0,0
254,12220,Bus,2013,0,0,0
255,12220,Bus,2014,0,0,0
256,12220,Bus,2015,0,0,0
257,12220,Bus,2016,0,0,0
258,12220,Bus,2017,0,0,0
259,12220,Bus,2018,0,0,0
260,12260,Bus,2002,89,110,199
261,12260,Bus,2003,94,138,232
262,12260,Bus,2004,119,112,231
263,12260,Bus,2005,130,78,208
264,12260,Bus,2006,123,76,199
265,12260,Bus,2007,95,132,227
266,12260,Bus,2012,92,127,219
267,12260,Bus,2013,117,124,241
268,12260,Bus,2014,288,118,406
269,12260,Bus,2015,103,183,286
270,12260,Bus,2016,268,124,392
271,12260,Bus,2017,305,143,448
272,12260,Bus,2018,202,143,345
273,12420,Bus,2002,1377,243,1620
274,12420,Bus,2003,2085,424,2509
275,12420,Bus,2004,4704,305,5009
276,12420,Bus,2005,3210,173,3383
277,12420,Bus,2006,2475,203,2678
278,12420,Bus,2007,1699,110,1809
279,12420,Bus,2012,3011,1201,4212
280,12420,Bus,2013,2229,1549,3778
281,12420,Bus,2014,512,234,746
282,12420,Bus,2015,5001,440,5441
283,12420,Bus,2016,4177,932,5109
284,12420,Bus,2017,3081,514,3595
285,12420,Bus,2018,3469,501,3970
286,12420,Rail,2002,0,0,0
287,12420,Rail,2003,0,0,0
288,12420,Rail,2004,0,0,0
289,12420,Rail,2005,0,0,0
290,12420,Rail,2006,0,0,0
291,12420,Rail,2007,0,0,0
292,12420,Rail,2012,0,0,0
293,12420,Rail,2013,0,0,0
294,12420,Rail,2014,0,0,0
295,12420,Rail,2015,0,0,0
296,12420,Rail,2016,0,0,0
297,12420,Rail,2017,0,0,0
298,12420,Rail,2018,0,0,0
299,12540,Bus,2002,468,325,793
300,12540,Bus,2003,571,335,906
301,12540,Bus,2004,448,457,905
302,12540,Bus,2005,417,440,857
303,12540,Bus,2006,427,344,771
304,12540,Bus,2007,330,299,629
305,12540,Bus,2012,276,188,464
306,12540,Bus,2013,250,179,429
307,12540,Bus,2014,320,212,532
308,12540,Bus,2015,253,168,421
309,12540,Bus,2016,331,85,416
310,12540,Bus,2017,331,193,524
311,12540,Bus,2018,461,184,645
312,12580,Bus,2002,3816,40,3856
313,12580,Bus,2003,4463,68,4531
314,12580,Bus,2004,3318,119,3437
315,12580,Bus,2005,4272,101,4373
316,12580,Bus,2006,3585,102,3687
317,12580,Bus,2007,3305,31,3336
318,12580,Bus,2012,3172,63,3235
319,12580,Bus,2013,3313,156,3469
320,12580,Bus,2014,3541,3932,7473
321,12580,Bus,2015,4646,4375,9021
322,12580,Bus,2016,4374,4269,8643
323,12580,Bus,2017,4472,4866,9338
324,12580,Bus,2018,4402,4936,9338
325,12580,Rail,2002,451,0,451
326,12580,Rail,2003,446,0,446
327,12580,Rail,2004,400,0,400
328,12580,Rail,2005,322,0,322
329,12580,Rail,2006,352,0,352
330,12580,Rail,2007,567,0,567
331,12580,Rail,2012,864,0,864
332,12580,Rail,2013,445,0,445
333,12580,Rail,2014,483,0,483
334,12580,Rail,2015,790,3293,4083
335,12580,Rail,2016,1248,3125,4373
336,12580,Rail,2017,1459,1382,2841
337,12580,Rail,2018,1344,1554,2898
338,12620,Bus,2002,11,2,13
339,12620,Bus,2003,6,8,14
340,12620,Bus,2004,12,0,12
341,12620,Bus,2005,16,0,16
342,12620,Bus,2006,36,2,38
343,12620,Bus,2007,24,0,24
344,12620,Bus,2012,0,0,0
345,12620,Bus,2013,0,0,0
346,12620,Bus,2014,0,0,0
347,12620,Bus,2015,0,0,0
348,12620,Bus,2016,0,0,0
349,12620,Bus,2017,0,0,0
350,12620,Bus,2018,0,0,0
351,12700,Bus,2002,0,0,0
352,12700,Bus,2003,0,0,0
353,12700,Bus,2004,0,0,0
354,12700,Bus,2005,0,0,0
355,12700,Bus,2006,0,0,0
356,12700,Bus,2007,0,0,0
357,12700,Bus,2012,29,148,177
358,12700,Bus,2013,35,212,247
359,12700,Bus,2014,31,198,229
360,12700,Bus,2015,101,157,258
361,12700,Bus,2016,86,113,199
362,12700,Bus,2017,91,121,212
363,12700,Bus,2018,92,79,171
364,12940,Bus,2002,261,60,321
365,12940,Bus,2003,236,86,322
366,12940,Bus,2004,546,583,1129
367,12940,Bus,2005,163,430,593
368,12940,Bus,2006,144,508,652
369,12940,Bus,2007,287,320,607
370,12940,Bus,2012,300,176,476
371,12940,Bus,2013,356,147,503
372,12940,Bus,2014,547,212,759
373,12940,Bus,2015,786,275,1061
374,12940,Bus,2016,622,255,877
375,12940,Bus,2017,348,206,554
376,12940,Bus,2018,369,190,559
377,12980,Bus,2002,22,14,36
378,12980,Bus,2003,25,17,42
379,12980,Bus,2004,30,20,50
380,12980,Bus,2005,32,24,56
381,12980,Bus,2006,34,27,61
382,12980,Bus,2007,37,31,68
383,12980,Bus,2012,0,0,0
384,12980,Bus,2013,0,0,0
385,12980,Bus,2014,0,0,0
386,12980,Bus,2015,0,0,0
387,12980,Bus,2016,0,0,0
388,12980,Bus,2017,0,0,0
389,12980,Bus,2018,0,0,0
390,13020,Bus,2002,3,72,75
391,13020,Bus,2003,2,50,52
392,13020,Bus,2004,2,82,84
393,13020,Bus,2005,7,87,94
394,13020,Bus,2006,5,75,80
395,13020,Bus,2007,1,52,53
396,13020,Bus,2012,35,23,58
397,13020,Bus,2013,23,26,49
398,13020,Bus,2014,25,24,49
399,13020,Bus,2015,23,20,43
400,13020,Bus,2016,24,13,37
401,13020,Bus,2017,15,17,32
402,13020,Bus,2018,20,35,55
403,13140,Bus,2002,53,83,136
404,13140,Bus,2003,56,80,136
405,13140,Bus,2004,56,93,149
406,13140,Bus,2005,48,123,171
407,13140,Bus,2006,50,72,122
408,13140,Bus,2007,48,31,79
409,13140,Bus,2012,28,8,36
410,13140,Bus,2013,30,9,39
411,13140,Bus,2014,36,12,48
412,13140,Bus,2015,42,8,50
413,13140,Bus,2016,5,15,20
414,13140,Bus,2017,6,18,24
415,13140,Bus,2018,7,19,26
416,13380,Bus,2002,135,133,268
417,13380,Bus,2003,58,176,234
418,13380,Bus,2004,62,292,354
419,13380,Bus,2005,41,254,295
420,13380,Bus,2006,28,214,242
421,13380,Bus,2007,57,48,105
422,13380,Bus,2012,87,28,115
423,13380,Bus,2013,133,72,205
424,13380,Bus,2014,175,55,230
425,13380,Bus,2015,156,48,204
426,13380,Bus,2016,124,51,175
427,13380,Bus,2017,146,12,158
428,13380,Bus,2018,127,16,143
429,13460,Bus,2002,0,0,0
430,13460,Bus,2003,0,0,0
431,13460,Bus,2004,0,0,0
432,13460,Bus,2005,0,0,0
433,13460,Bus,2006,0,0,0
434,13460,Bus,2007,0,0,0
435,13460,Bus,2012,5,5,10
436,13460,Bus,2013,5,5,10
437,13460,Bus,2014,25,16,41
438,13460,Bus,2015,31,25,56
439,13460,Bus,2016,6,3,9
440,13460,Bus,2017,28,4,32
441,13460,Bus,2018,18,15,33
442,13740,Bus,2002,23,9,32
443,13740,Bus,2003,27,12,39
444,13740,Bus,2004,25,9,34
445,13740,Bus,2005,21,7,28
446,13740,Bus,2006,19,4,23
447,13740,Bus,2007,20,6,26
448,13740,Bus,2012,61,134,195
449,13740,Bus,2013,73,158,231
450,13740,Bus,2014,73,158,231
451,13740,Bus,2015,216,274,490
452,13740,Bus,2016,248,283,531
453,13740,Bus,2017,198,347,545
454,13740,Bus,2018,303,205,508
455,13780,Bus,2002,228,970,1198
456,13780,Bus,2003,295,917,1212
457,13780,Bus,2004,214,602,816
458,13780,Bus,2005,300,550,850
459,13780,Bus,2006,183,499,682
460,13780,Bus,2007,208,550,758
461,13780,Bus,2012,111,485,596
462,13780,Bus,2013,134,494,628
463,13780,Bus,2014,155,494,649
464,13780,Bus,2015,210,384,594
465,13780,Bus,2016,193,557,750
466,13780,Bus,2017,208,484,692
467,13780,Bus,2018,174,454,628
468,13820,Bus,2002,0,0,0
469,13820,Bus,2003,0,0,0
470,13820,Bus,2004,1401,999,2400
471,13820,Bus,2005,840,574,1414
472,13820,Bus,2006,1141,607,1748
473,13820,Bus,2007,1246,668,1914
474,13820,Bus,2012,788,572,1360
475,13820,Bus,2013,967,690,1657
476,13820,Bus,2014,391,471,862
477,13820,Bus,2015,576,792,1368
478,13820,Bus,2016,1136,950,2086
479,13820,Bus,2017,749,608,1357
480,13820,Bus,2018,350,257,607
481,13900,Bus,2002,0,0,0
482,13900,Bus,2003,0,0,0
483,13900,Bus,2004,0,0,0
484,13900,Bus,2005,0,0,0
485,13900,Bus,2006,0,0,0
486,13900,Bus,2007,0,0,0
487,13900,Bus,2012,5,0,5
488,13900,Bus,2013,0,0,0
489,13900,Bus,2014,0,0,0
490,13900,Bus,2015,0,0,0
491,13900,Bus,2016,0,0,0
492,13900,Bus,2017,0,0,0
493,13900,Bus,2018,0,0,0
494,13980,Bus,2002,0,0,0
495,13980,Bus,2003,0,0,0
496,13980,Bus,2004,0,0,0
497,13980,Bus,2005,3,17,20
498,13980,Bus,2006,10,4,14
499,13980,Bus,2007,8,25,33
500,13980,Bus,2012,127,153,280
501,13980,Bus,2013,205,38,243
502,13980,Bus,2014,168,53,221
503,13980,Bus,2015,120,82,202
504,13980,Bus,2016,136,76,212
505,13980,Bus,2017,155,118,273
506,13980,Bus,2018,173,139,312
507,14020,Bus,2002,102,0,102
508,14020,Bus,2003,123,210,333
509,14020,Bus,2004,116,190,306
510,14020,Bus,2005,171,160,331
511,14020,Bus,2006,124,134,258
512,14020,Bus,2007,105,78,183
513,14020,Bus,2012,204,151,355
514,14020,Bus,2013,222,88,310
515,14020,Bus,2014,181,94,275
516,14020,Bus,2015,122,102,224
517,14020,Bus,2016,151,125,276
518,14020,Bus,2017,162,93,255
519,14020,Bus,2018,116,40,156
520,14060,Bus,2002,87,372,459
521,14060,Bus,2003,95,437,532
522,14060,Bus,2004,144,557,701
523,14060,Bus,2005,190,277,467
524,14060,Bus,2006,180,391,571
525,14060,Bus,2007,191,258,449
526,14060,Bus,2012,26,226,252
527,14060,Bus,2013,31,187,218
528,14060,Bus,2014,38,208,246
529,14060,Bus,2015,29,273,302
530,14060,Bus,2016,45,300,345
531,14060,Bus,2017,43,399,442
532,14060,Bus,2018,65,355,420
533,14260,Bus,2002,309,292,601
534,14260,Bus,2003,209,130,339
535,14260,Bus,2004,195,58,253
536,14260,Bus,2005,124,131,255
537,14260,Bus,2006,320,104,424
538,14260,Bus,2007,164,124,288
539,14260,Bus,2012,97,38,135
540,14260,Bus,2013,92,22,114
541,14260,Bus,2014,87,16,103
542,14260,Bus,2015,77,32,109
543,14260,Bus,2016,94,15,109
544,14260,Bus,2017,101,26,127
545,14260,Bus,2018,30,59,89
546,14460,Bus,2002,1860,3615,5475
547,14460,Bus,2003,2097,3915,6012
548,14460,Bus,2004,1812,1883,3695
549,14460,Bus,2005,6406,292,6698
550,14460,Bus,2006,8198,423,8621
551,14460,Bus,2007,4378,516,4894
552,14460,Bus,2012,2191,1948,4139
553,14460,Bus,2013,1735,1954,3689
554,14460,Bus,2014,2002,1626,3628
555,14460,Bus,2015,1983,1590,3573
556,14460,Bus,2016,1733,1492,3225
557,14460,Bus,2017,2144,1116,3260
558,14460,Bus,2018,1252,756,2008
559,14460,Rail,2002,1962,385,2347
560,14460,Rail,2003,2291,924,3215
561,14460,Rail,2004,3134,817,3951
562,14460,Rail,2005,2234,1004,3238
563,14460,Rail,2006,1757,1185,2942
564,14460,Rail,2007,1639,1006,2645
565,14460,Rail,2012,2181,193,2374
566,14460,Rail,2013,1775,149,1924
567,14460,Rail,2014,1674,142,1816
568,14460,Rail,2015,2099,220,2319
569,14460,Rail,2016,1795,148,1943
570,14460,Rail,2017,1496,145,1641
571,14460,Rail,2018,1287,142,1429
572,14740,Bus,2002,92,53,145
573,14740,Bus,2003,114,26,140
574,14740,Bus,2004,92,32,124
575,14740,Bus,2005,129,28,157
576,14740,Bus,2006,106,41,147
577,14740,Bus,2007,139,25,164
578,14740,Bus,2012,48,34,82
579,14740,Bus,2013,140,2,142
580,14740,Bus,2014,22,57,79
581,14740,Bus,2015,123,17,140
582,14740,Bus,2016,80,14,94
583,14740,Bus,2017,20,23,43
584,14740,Bus,2018,21,28,49
585,14860,Bus,2002,916,757,1673
586,14860,Bus,2003,968,718,1686
587,14860,Bus,2004,1097,811,1908
588,14860,Bus,2005,1291,1066,2357
589,14860,Bus,2006,1206,858,2064
590,14860,Bus,2007,1166,761,1927
591,14860,Bus,2012,1145,727,1872
592,14860,Bus,2013,791,869,1660
593,14860,Bus,2014,695,881,1576
594,14860,Bus,2015,636,749,1385
595,14860,Bus,2016,669,816,1485
596,14860,Bus,2017,652,1056,1708
597,14860,Bus,2018,376,1102,1478
598,15180,Bus,2002,200,361,561
599,15180,Bus,2003,101,406,507
600,15180,Bus,2004,86,342,428
601,15180,Bus,2005,52,220,272
602,15180,Bus,2006,38,160,198
603,15180,Bus,2007,413,97,510
604,15180,Bus,2012,187,358,545
605,15180,Bus,2013,301,427,728
606,15180,Bus,2014,979,1517,2496
607,15180,Bus,2015,871,562,1433
608,15180,Bus,2016,247,103,350
609,15180,Bus,2017,142,38,180
610,15180,Bus,2018,151,17,168
611,15380,Bus,2002,1424,2158,3582
612,15380,Bus,2003,1978,2885,4863
613,15380,Bus,2004,1799,2907,4706
614,15380,Bus,2005,1722,2718,4440
615,15380,Bus,2006,1949,2984,4933
616,15380,Bus,2007,1732,2935,4667
617,15380,Bus,2012,1078,1947,3025
618,15380,Bus,2013,904,1936,2840
619,15380,Bus,2014,951,1986,2937
620,15380,Bus,2015,880,1473,2353
621,15380,Bus,2016,985,1533,2518
622,15380,Bus,2017,786,1519,2305
623,15380,Bus,2018,726,1329,2055
624,15380,Rail,2002,3,6,9
625,15380,Rail,2003,3,3,6
626,15380,Rail,2004,3,4,7
627,15380,Rail,2005,18,11,29
628,15380,Rail,2006,3,28,31
629,15380,Rail,2007,4,33,37
630,15380,Rail,2012,2,47,49
631,15380,Rail,2013,1,49,50
632,15380,Rail,2014,3,64,67
633,15380,Rail,2015,7,44,51
634,15380,Rail,2016,5,51,56
635,15380,Rail,2017,7,41,48
636,15380,Rail,2018,54,9,63
637,15540,Bus,2002,52,58,110
638,15540,Bus,2003,53,70,123
639,15540,Bus,2004,51,120,171
640,15540,Bus,2005,55,104,159
641,15540,Bus,2006,109,155,264
642,15540,Bus,2007,117,158,275
643,15540,Bus,2012,47,5,52
644,15540,Bus,2013,56,40,96
645,15540,Bus,2014,59,46,105
646,15540,Bus,2015,47,30,77
647,15540,Bus,2016,98,108,206
648,15540,Bus,2017,121,137,258
649,15540,Bus,2018,84,110,194
650,15940,Bus,2002,3,511,514
651,15940,Bus,2003,238,253,491
652,15940,Bus,2004,114,118,232
653,15940,Bus,2005,103,113,216
654,15940,Bus,2006,118,120,238
655,15940,Bus,2007,129,107,236
656,15940,Bus,2012,86,85,171
657,15940,Bus,2013,94,103,197
658,15940,Bus,2014,26,113,139
659,15940,Bus,2015,84,79,163
660,15940,Bus,2016,136,389,525
661,15940,Bus,2017,119,431,550
662,15940,Bus,2018,105,841,946
663,15980,Bus,2002,377,247,624
664,15980,Bus,2003,168,157,325
665,15980,Bus,2004,175,438,613
666,15980,Bus,2005,135,310,445
667,15980,Bus,2006,86,285,371
668,15980,Bus,2007,58,99,157
669,15980,Bus,2012,197,108,305
670,15980,Bus,2013,123,74,197
671,15980,Bus,2014,93,46,139
672,15980,Bus,2015,111,35,146
673,15980,Bus,2016,115,34,149
674,15980,Bus,2017,206,36,242
675,15980,Bus,2018,195,92,287
676,16220,Bus,2002,0,0,0
677,16220,Bus,2003,0,0,0
678,16220,Bus,2004,0,0,0
679,16220,Bus,2005,0,0,0
680,16220,Bus,2006,0,0,0
681,16220,Bus,2007,0,0,0
682,16220,Bus,2012,0,0,0
683,16220,Bus,2013,0,0,0
684,16220,Bus,2014,0,0,0
685,16220,Bus,2015,0,0,0
686,16220,Bus,2016,0,0,0
687,16220,Bus,2017,0,0,0
688,16220,Bus,2018,0,0,0
689,16300,Bus,2002,213,64,277
690,16300,Bus,2003,131,87,218
691,16300,Bus,2004,229,77,306
692,16300,Bus,2005,234,80,314
693,16300,Bus,2006,198,112,310
694,16300,Bus,2007,277,87,364
695,16300,Bus,2012,48,80,128
696,16300,Bus,2013,49,109,158
697,16300,Bus,2014,49,72,121
698,16300,Bus,2015,32,56,88
699,16300,Bus,2016,25,78,103
700,16300,Bus,2017,31,74,105
701,16300,Bus,2018,25,80,105
702,16580,Bus,2002,139,100,239
703,16580,Bus,2003,65,168,233
704,16580,Bus,2004,73,178,251
705,16580,Bus,2005,51,125,176
706,16580,Bus,2006,24,114,138
707,16580,Bus,2007,63,23,86
708,16580,Bus,2012,108,31,139
709,16580,Bus,2013,84,43,127
710,16580,Bus,2014,75,40,115
711,16580,Bus,2015,65,47,112
712,16580,Bus,2016,85,46,131
713,16580,Bus,2017,89,41,130
714,16580,Bus,2018,200,229,429
715,16620,Bus,2002,16,1563,1579
716,16620,Bus,2003,12,1661,1673
717,16620,Bus,2004,13,1583,1596
718,16620,Bus,2005,8,1282,1290
719,16620,Bus,2006,10,1217,1227
720,16620,Bus,2007,5,1423,1428
721,16620,Bus,2012,378,1004,1382
722,16620,Bus,2013,255,945,1200
723,16620,Bus,2014,300,572,872
724,16620,Bus,2015,296,1017,1313
725,16620,Bus,2016,285,1039,1324
726,16620,Bus,2017,298,1109,1407
727,16620,Bus,2018,271,1146,1417
728,16700,Bus,2002,0,0,0
729,16700,Bus,2003,0,0,0
730,16700,Bus,2004,0,0,0
731,16700,Bus,2005,0,0,0
732,16700,Bus,2006,0,0,0
733,16700,Bus,2007,0,0,0
734,16700,Bus,2012,10,185,195
735,16700,Bus,2013,185,32,217
736,16700,Bus,2014,221,31,252
737,16700,Bus,2015,161,36,197
738,16700,Bus,2016,133,27,160
739,16700,Bus,2017,177,36,213
740,16700,Bus,2018,154,32,186
741,16740,Bus,2002,819,3708,4527
742,16740,Bus,2003,1278,4251,5529
743,16740,Bus,2004,712,3914,4626
744,16740,Bus,2005,767,8339,9106
745,16740,Bus,2006,907,10002,10909
746,16740,Bus,2007,1359,10172,11531
747,16740,Bus,2012,883,9199,10082
748,16740,Bus,2013,872,8863,9735
749,16740,Bus,2014,937,15047,15984
750,16740,Bus,2015,996,6607,7603
751,16740,Bus,2016,622,1954,2576
752,16740,Bus,2017,880,1883,2763
753,16740,Bus,2018,908,2634,3542
754,16740,Rail,2002,0,0,0
755,16740,Rail,2003,0,0,0
756,16740,Rail,2004,0,0,0
757,16740,Rail,2005,5,7,12
758,16740,Rail,2006,4,0,4
759,16740,Rail,2007,0,0,0
760,16740,Rail,2012,89,31,120
761,16740,Rail,2013,86,8,94
762,16740,Rail,2014,111,6,117
763,16740,Rail,2015,95,2,97
764,16740,Rail,2016,280,40,320
765,16740,Rail,2017,274,44,318
766,16740,Rail,2018,410,35,445
767,16820,Bus,2002,8,9,17
768,16820,Bus,2003,13,69,82
769,16820,Bus,2004,14,20,34
770,16820,Bus,2005,13,8,21
771,16820,Bus,2006,88,128,216
772,16820,Bus,2007,9,142,151
773,16820,Bus,2012,0,0,0
774,16820,Bus,2013,0,0,0
775,16820,Bus,2014,0,0,0
776,16820,Bus,2015,0,0,0
777,16820,Bus,2016,0,0,0
778,16820,Bus,2017,0,0,0
779,16820,Bus,2018,0,0,0
780,16860,Bus,2002,8,287,295
781,16860,Bus,2003,9,279,288
782,16860,Bus,2004,8,284,292
783,16860,Bus,2005,7,277,284
784,16860,Bus,2006,8,283,291
785,16860,Bus,2007,136,314,450
786,16860,Bus,2012,219,460,679
787,16860,Bus,2013,239,399,638
788,16860,Bus,2014,222,178,400
789,16860,Bus,2015,161,80,241
790,16860,Bus,2016,207,128,335
791,16860,Bus,2017,201,109,310
792,16860,Bus,2018,215,114,329
793,16860,Rail,2002,0,5,5
794,16860,Rail,2003,0,6,6
795,16860,Rail,2004,0,7,7
796,16860,Rail,2005,0,6,6
797,16860,Rail,2006,0,5,5
798,16860,Rail,2007,2,7,9
799,16860,Rail,2012,117,0,117
800,16860,Rail,2013,0,0,0
801,16860,Rail,2014,2,0,2
802,16860,Rail,2015,1,0,1
803,16860,Rail,2016,1,0,1
804,16860,Rail,2017,0,0,0
805,16860,Rail,2018,1,0,1
806,16940,Bus,2002,4,26,30
807,16940,Bus,2003,16,7,23
808,16940,Bus,2004,13,25,38
809,16940,Bus,2005,40,35,75
810,16940,Bus,2006,18,21,39
811,16940,Bus,2007,20,23,43
812,16940,Bus,2012,0,0,0
813,16940,Bus,2013,0,0,0
814,16940,Bus,2014,0,0,0
815,16940,Bus,2015,0,0,0
816,16940,Bus,2016,0,0,0
817,16940,Bus,2017,0,0,0
818,16940,Bus,2018,0,0,0
819,16980,Bus,2002,19666,2158,21824
820,16980,Bus,2003,18393,1738,20131
821,16980,Bus,2004,17109,1389,18498
822,16980,Bus,2005,18797,921,19718
823,16980,Bus,2006,18706,923,19629
824,16980,Bus,2007,14824,6704,21528
825,16980,Bus,2012,7649,11441,19090
826,16980,Bus,2013,8963,11208,20171
827,16980,Bus,2014,10915,10682,21597
828,16980,Bus,2015,8174,9769,17943
829,16980,Bus,2016,10960,10110,21070
830,16980,Bus,2017,11316,8025,19341
831,16980,Bus,2018,11502,7991,19493
832,16980,Rail,2002,234,30,264
833,16980,Rail,2003,194,15,209
834,16980,Rail,2004,170,27,197
835,16980,Rail,2005,358,45,403
836,16980,Rail,2006,350,19175,19525
837,16980,Rail,2007,343,25052,25395
838,16980,Rail,2012,367,18126,18493
839,16980,Rail,2013,385,16697,17082
840,16980,Rail,2014,463,13726,14189
841,16980,Rail,2015,329,11103,11432
842,16980,Rail,2016,336,9121,9457
843,16980,Rail,2017,396,9888,10284
844,16980,Rail,2018,561,10219,10780
845,17020,Bus,2002,0,0,0
846,17020,Bus,2003,0,0,0
847,17020,Bus,2004,0,0,0
848,17020,Bus,2005,0,0,0
849,17020,Bus,2006,0,0,0
850,17020,Bus,2007,0,0,0
851,17020,Bus,2012,36,18,54
852,17020,Bus,2013,35,20,55
853,17020,Bus,2014,42,39,81
854,17020,Bus,2015,55,19,74
855,17020,Bus,2016,44,27,71
856,17020,Bus,2017,51,19,70
857,17020,Bus,2018,35,21,56
858,17140,Bus,2002,1287,447,1734
859,17140,Bus,2003,765,940,1705
860,17140,Bus,2004,625,920,1545
861,17140,Bus,2005,517,888,1405
862,17140,Bus,2006,608,917,1525
863,17140,Bus,2007,623,1075,1698
864,17140,Bus,2012,614,1052,1666
865,17140,Bus,2013,2109,2769,4878
866,17140,Bus,2014,2140,2127,4267
867,17140,Bus,2015,2232,1587,3819
868,17140,Bus,2016,2258,2061,4319
869,17140,Bus,2017,2043,2147,4190
870,17140,Bus,2018,1946,1672,3618
871,17140,Rail,2002,0,0,0
872,17140,Rail,2003,0,0,0
873,17140,Rail,2004,0,0,0
874,17140,Rail,2005,0,0,0
875,17140,Rail,2006,0,0,0
876,17140,Rail,2007,0,0,0
877,17140,Rail,2012,0,0,0
878,17140,Rail,2013,0,0,0
879,17140,Rail,2014,0,0,0
880,17140,Rail,2015,0,0,0
881,17140,Rail,2016,31,5,36
882,17140,Rail,2017,89,67,156
883,17140,Rail,2018,94,56,150
884,17300,Bus,2002,50,3,53
885,17300,Bus,2003,52,5,57
886,17300,Bus,2004,57,0,57
887,17300,Bus,2005,65,0,65
888,17300,Bus,2006,73,0,73
889,17300,Bus,2007,72,0,72
890,17300,Bus,2012,56,99,155
891,17300,Bus,2013,91,102,193
892,17300,Bus,2014,94,83,177
893,17300,Bus,2015,0,0,0
894,17300,Bus,2016,0,0,0
895,17300,Bus,2017,0,0,0
896,17300,Bus,2018,0,0,0
897,17460,Bus,2002,3359,807,4166
898,17460,Bus,2003,2037,583,2620
899,17460,Bus,2004,1693,418,2111
900,17460,Bus,2005,1986,213,2199
901,17460,Bus,2006,2011,297,2308
902,17460,Bus,2007,1327,288,1615
903,17460,Bus,2012,1429,349,1778
904,17460,Bus,2013,1367,238,1605
905,17460,Bus,2014,1613,181,1794
906,17460,Bus,2015,1089,428,1517
907,17460,Bus,2016,1329,563,1892
908,17460,Bus,2017,1055,205,1260
909,17460,Bus,2018,727,171,898
910,17460,Rail,2002,116,59,175
911,17460,Rail,2003,141,55,196
912,17460,Rail,2004,150,77,227
913,17460,Rail,2005,192,59,251
914,17460,Rail,2006,147,54,201
915,17460,Rail,2007,154,47,201
916,17460,Rail,2012,127,85,212
917,17460,Rail,2013,39,35,74
918,17460,Rail,2014,33,27,60
919,17460,Rail,2015,38,17,55
920,17460,Rail,2016,253,3161,3414
921,17460,Rail,2017,228,2779,3007
922,17460,Rail,2018,123,2411,2534
923,17660,Bus,2002,0,0,0
924,17660,Bus,2003,0,0,0
925,17660,Bus,2004,0,0,0
926,17660,Bus,2005,0,0,0
927,17660,Bus,2006,0,0,0
928,17660,Bus,2007,0,0,0
929,17660,Bus,2012,0,0,0
930,17660,Bus,2013,0,0,0
931,17660,Bus,2014,0,0,0
932,17660,Bus,2015,0,0,0
933,17660,Bus,2016,0,0,0
934,17660,Bus,2017,0,0,0
935,17660,Bus,2018,0,0,0
936,17780,Bus,2002,14,13,27
937,17780,Bus,2003,12,11,23
938,17780,Bus,2004,11,12,23
939,17780,Bus,2005,27,21,48
940,17780,Bus,2006,18,15,33
941,17780,Bus,2007,34,37,71
942,17780,Bus,2012,11,17,28
943,17780,Bus,2013,10,20,30
944,17780,Bus,2014,26,35,61
945,17780,Bus,2015,43,48,91
946,17780,Bus,2016,16,61,77
947,17780,Bus,2017,47,41,88
948,17780,Bus,2018,64,22,86
949,17820,Bus,2002,434,369,803
950,17820,Bus,2003,383,322,705
951,17820,Bus,2004,406,353,759
952,17820,Bus,2005,0,0,0
953,17820,Bus,2006,0,0,0
954,17820,Bus,2007,0,0,0
955,17820,Bus,2012,183,185,368
956,17820,Bus,2013,100,217,317
957,17820,Bus,2014,302,163,465
958,17820,Bus,2015,217,114,331
959,17820,Bus,2016,268,257,525
960,17820,Bus,2017,326,187,513
961,17820,Bus,2018,55,397,452
962,17860,Bus,2002,10,14,24
963,17860,Bus,2003,2,17,19
964,17860,Bus,2004,5,0,5
965,17860,Bus,2005,21,0,21
966,17860,Bus,2006,28,0,28
967,17860,Bus,2007,17,0,17
968,17860,Bus,2012,48,30,78
969,17860,Bus,2013,71,71,142
970,17860,Bus,2014,247,20,267
971,17860,Bus,2015,212,58,270
972,17860,Bus,2016,160,3,163
973,17860,Bus,2017,150,3,153
974,17860,Bus,2018,63,308,371
975,17900,Bus,2002,0,0,0
976,17900,Bus,2003,0,0,0
977,17900,Bus,2004,0,0,0
978,17900,Bus,2005,0,0,0
979,17900,Bus,2006,0,0,0
980,17900,Bus,2007,0,0,0
981,17900,Bus,2012,10,73,83
982,17900,Bus,2013,114,50,164
983,17900,Bus,2014,136,86,222
984,17900,Bus,2015,98,47,145
985,17900,Bus,2016,289,24,313
986,17900,Bus,2017,377,356,733
987,17900,Bus,2018,413,198,611
988,17980,Bus,2002,181,75,256
989,17980,Bus,2003,210,108,318
990,17980,Bus,2004,188,119,307
991,17980,Bus,2005,152,191,343
992,17980,Bus,2006,113,215,328
993,17980,Bus,2007,120,190,310
994,17980,Bus,2012,0,0,0
995,17980,Bus,2013,0,0,0
996,17980,Bus,2014,0,0,0
997,17980,Bus,2015,0,0,0
998,17980,Bus,2016,0,0,0
999,17980,Bus,2017,0,0,0
1000,17980,Bus,2018,0,0,0
1001,18140,Bus,2002,1786,630,2416
1002,18140,Bus,2003,1937,678,2615
1003,18140,Bus,2004,1782,556,2338
1004,18140,Bus,2005,1472,425,1897
1005,18140,Bus,2006,1244,377,1621
1006,18140,Bus,2007,1394,504,1898
1007,18140,Bus,2012,2024,1351,3375
1008,18140,Bus,2013,2049,1221,3270
1009,18140,Bus,2014,2123,1214,3337
1010,18140,Bus,2015,2171,1239,3410
1011,18140,Bus,2016,2329,1567,3896
1012,18140,Bus,2017,2075,1096,3171
1013,18140,Bus,2018,2825,1263,4088
1014,18580,Bus,2002,139,172,311
1015,18580,Bus,2003,199,97,296
1016,18580,Bus,2004,134,163,297
1017,18580,Bus,2005,111,288,399
1018,18580,Bus,2006,784,633,1417
1019,18580,Bus,2007,752,598,1350
1020,18580,Bus,2012,92,485,577
1021,18580,Bus,2013,47,482,529
1022,18580,Bus,2014,98,401,499
1023,18580,Bus,2015,228,219,447
1024,18580,Bus,2016,240,164,404
1025,18580,Bus,2017,158,124,282
1026,18580,Bus,2018,112,83,195
1027,18700,Bus,2002,0,0,0
1028,18700,Bus,2003,0,0,0
1029,18700,Bus,2004,0,0,0
1030,18700,Bus,2005,0,0,0
1031,18700,Bus,2006,0,0,0
1032,18700,Bus,2007,0,0,0
1033,18700,Bus,2012,36,11,47
1034,18700,Bus,2013,20,8,28
1035,18700,Bus,2014,22,10,32
1036,18700,Bus,2015,23,9,32
1037,18700,Bus,2016,16,10,26
1038,18700,Bus,2017,19,11,30
1039,18700,Bus,2018,17,12,29
1040,18880,Bus,2002,0,0,0
1041,18880,Bus,2003,0,0,0
1042,18880,Bus,2004,0,0,0
1043,18880,Bus,2005,0,0,0
1044,18880,Bus,2006,0,0,0
1045,18880,Bus,2007,0,0,0
1046,18880,Bus,2012,11,4,15
1047,18880,Bus,2013,19,0,19
1048,18880,Bus,2014,4,5,9
1049,18880,Bus,2015,17,6,23
1050,18880,Bus,2016,15,9,24
1051,18880,Bus,2017,13,14,27
1052,18880,Bus,2018,20,17,37
1053,19060,Bus,2002,0,0,0
1054,19060,Bus,2003,0,0,0
1055,19060,Bus,2004,0,0,0
1056,19060,Bus,2005,0,0,0
1057,19060,Bus,2006,1,0,1
1058,19060,Bus,2007,0,0,0
1059,19060,Bus,2012,0,0,0
1060,19060,Bus,2013,0,0,0
1061,19060,Bus,2014,0,0,0
1062,19060,Bus,2015,0,0,0
1063,19060,Bus,2016,0,0,0
1064,19060,Bus,2017,0,0,0
1065,19060,Bus,2018,0,0,0
1066,19100,Bus,2002,3364,3804,7168
1067,19100,Bus,2003,2667,3302,5969
1068,19100,Bus,2004,3751,3729,7480
1069,19100,Bus,2005,3888,3455,7343
1070,19100,Bus,2006,3877,2840,6717
1071,19100,Bus,2007,4289,2993,7282
1072,19100,Bus,2012,3833,2754,6587
1073,19100,Bus,2013,3894,2531,6425
1074,19100,Bus,2014,3233,2027,5260
1075,19100,Bus,2015,2590,1893,4483
1076,19100,Bus,2016,2770,2040,4810
1077,19100,Bus,2017,2541,1972,4513
1078,19100,Bus,2018,2923,2692,5615
1079,19100,Rail,2002,32,7,39
1080,19100,Rail,2003,40,22,62
1081,19100,Rail,2004,92,43,135
1082,19100,Rail,2005,115,38,153
1083,19100,Rail,2006,89,36,125
1084,19100,Rail,2007,89,36,125
1085,19100,Rail,2012,149,127,276
1086,19100,Rail,2013,193,105,298
1087,19100,Rail,2014,122,111,233
1088,19100,Rail,2015,130,197,327
1089,19100,Rail,2016,132,229,361
1090,19100,Rail,2017,313,246,559
1091,19100,Rail,2018,232,91,323
1092,19340,Bus,2002,122,172,294
1093,19340,Bus,2003,254,133,387
1094,19340,Bus,2004,158,106,264
1095,19340,Bus,2005,155,132,287
1096,19340,Bus,2006,127,162,289
1097,19340,Bus,2007,274,91,365
1098,19340,Bus,2012,156,60,216
1099,19340,Bus,2013,261,168,429
1100,19340,Bus,2014,379,222,601
1101,19340,Bus,2015,141,112,253
1102,19340,Bus,2016,278,228,506
1103,19340,Bus,2017,289,130,419
1104,19340,Bus,2018,412,93,505
1105,19380,Bus,2002,3133,3192,6325
1106,19380,Bus,2003,2350,2021,4371
1107,19380,Bus,2004,2308,1251,3559
1108,19380,Bus,2005,2923,1989,4912
1109,19380,Bus,2006,2861,1481,4342
1110,19380,Bus,2007,2712,1619,4331
1111,19380,Bus,2012,1367,1153,2520
1112,19380,Bus,2013,1790,1019,2809
1113,19380,Bus,2014,1851,504,2355
1114,19380,Bus,2015,3478,185,3663
1115,19380,Bus,2016,5134,249,5383
1116,19380,Bus,2017,2169,3124,5293
1117,19380,Bus,2018,2592,2134,4726
1118,19500,Bus,2002,202,15,217
1119,19500,Bus,2003,73,3,76
1120,19500,Bus,2004,36,10,46
1121,19500,Bus,2005,47,13,60
1122,19500,Bus,2006,69,12,81
1123,19500,Bus,2007,299,26,325
1124,19500,Bus,2012,227,109,336
1125,19500,Bus,2013,334,56,390
1126,19500,Bus,2014,188,38,226
1127,19500,Bus,2015,189,95,284
1128,19500,Bus,2016,163,72,235
1129,19500,Bus,2017,185,96,281
1130,19500,Bus,2018,181,72,253
1131,19660,Bus,2002,15,2,17
1132,19660,Bus,2003,26,3,29
1133,19660,Bus,2004,173,122,295
1134,19660,Bus,2005,271,77,348
1135,19660,Bus,2006,427,116,543
1136,19660,Bus,2007,417,245,662
1137,19660,Bus,2012,383,126,509
1138,19660,Bus,2013,469,93,562
1139,19660,Bus,2014,179,400,579
1140,19660,Bus,2015,175,428,603
1141,19660,Bus,2016,302,181,483
1142,19660,Bus,2017,329,90,419
1143,19660,Bus,2018,398,130,528
1144,19740,Bus,2002,1155,502,1657
1145,19740,Bus,2003,696,402,1098
1146,19740,Bus,2004,665,516,1181
1147,19740,Bus,2005,696,474,1170
1148,19740,Bus,2006,668,400,1068
1149,19740,Bus,2007,734,450,1184
1150,19740,Bus,2012,1064,1312,2376
1151,19740,Bus,2013,993,1226,2219
1152,19740,Bus,2014,1005,1221,2226
1153,19740,Bus,2015,627,593,1220
1154,19740,Bus,2016,679,775,1454
1155,19740,Bus,2017,644,926,1570
1156,19740,Bus,2018,710,1507,2217
1157,19740,Rail,2002,0,0,0
1158,19740,Rail,2003,0,0,0
1159,19740,Rail,2004,1,2,3
1160,19740,Rail,2005,1,2,3
1161,19740,Rail,2006,0,0,0
1162,19740,Rail,2007,7,11,18
1163,19740,Rail,2012,191,193,384
1164,19740,Rail,2013,252,135,387
1165,19740,Rail,2014,278,158,436
1166,19740,Rail,2015,303,174,477
1167,19740,Rail,2016,330,171,501
1168,19740,Rail,2017,355,426,781
1169,19740,Rail,2018,383,450,833
1170,19780,Bus,2002,136,360,496
1171,19780,Bus,2003,272,142,414
1172,19780,Bus,2004,380,88,468
1173,19780,Bus,2005,443,18,461
1174,19780,Bus,2006,445,38,483
1175,19780,Bus,2007,297,106,403
1176,19780,Bus,2012,456,67,523
1177,19780,Bus,2013,439,47,486
1178,19780,Bus,2014,442,84,526
1179,19780,Bus,2015,542,81,623
1180,19780,Bus,2016,324,480,804
1181,19780,Bus,2017,699,532,1231
1182,19780,Bus,2018,497,255,752
1183,19820,Bus,2002,6460,2690,9150
1184,19820,Bus,2003,6425,3023,9448
1185,19820,Bus,2004,14437,4118,18555
1186,19820,Bus,2005,14363,3821,18184
1187,19820,Bus,2006,11819,4701,16520
1188,19820,Bus,2007,6213,5108,11321
1189,19820,Bus,2012,5807,3689,9496
1190,19820,Bus,2013,5049,3015,8064
1191,19820,Bus,2014,6079,4209,10288
1192,19820,Bus,2015,6720,3609,10329
1193,19820,Bus,2016,3150,2463,5613
1194,19820,Bus,2017,3188,1982,5170
1195,19820,Bus,2018,2844,2844,5688
1196,19820,Rail,2002,10,9,19
1197,19820,Rail,2003,20,15,35
1198,19820,Rail,2004,5,4,9
1199,19820,Rail,2005,2,4,6
1200,19820,Rail,2006,0,22,22
1201,19820,Rail,2007,4,24,28
1202,19820,Rail,2012,364,72,436
1203,19820,Rail,2013,245,132,377
1204,19820,Rail,2014,269,140,409
1205,19820,Rail,2015,94,216,310
1206,19820,Rail,2016,60,188,248
1207,19820,Rail,2017,81,220,301
1208,19820,Rail,2018,85,239,324
1209,20220,Bus,2002,116,27,143
1210,20220,Bus,2003,54,35,89
1211,20220,Bus,2004,38,20,58
1212,20220,Bus,2005,45,31,76
1213,20220,Bus,2006,53,41,94
1214,20220,Bus,2007,37,48,85
1215,20220,Bus,2012,0,0,0
1216,20220,Bus,2013,0,0,0
1217,20220,Bus,2014,0,0,0
1218,20220,Bus,2015,0,0,0
1219,20220,Bus,2016,0,0,0
1220,20220,Bus,2017,0,0,0
1221,20220,Bus,2018,0,0,0
1222,20260,Bus,2002,155,128,283
1223,20260,Bus,2003,1,285,286
1224,20260,Bus,2004,2,422,424
1225,20260,Bus,2005,0,241,241
1226,20260,Bus,2006,0,333,333
1227,20260,Bus,2007,0,235,235
1228,20260,Bus,2012,202,86,288
1229,20260,Bus,2013,195,94,289
1230,20260,Bus,2014,236,266,502
1231,20260,Bus,2015,257,107,364
1232,20260,Bus,2016,241,112,353
1233,20260,Bus,2017,196,185,381
1234,20260,Bus,2018,150,191,341
1235,20500,Bus,2002,230,129,359
1236,20500,Bus,2003,261,116,377
1237,20500,Bus,2004,274,120,394
1238,20500,Bus,2005,300,124,424
1239,20500,Bus,2006,321,86,407
1240,20500,Bus,2007,136,99,235
1241,20500,Bus,2012,537,260,797
1242,20500,Bus,2013,413,329,742
1243,20500,Bus,2014,345,134,479
1244,20500,Bus,2015,404,431,835
1245,20500,Bus,2016,787,358,1145
1246,20500,Bus,2017,412,437,849
1247,20500,Bus,2018,306,422,728
1248,20740,Bus,2002,34,287,321
1249,20740,Bus,2003,17,182,199
1250,20740,Bus,2004,10,253,263
1251,20740,Bus,2005,9,120,129
1252,20740,Bus,2006,13,171,184
1253,20740,Bus,2007,18,215,233
1254,20740,Bus,2012,33,226,259
1255,20740,Bus,2013,20,186,206
1256,20740,Bus,2014,26,142,168
1257,20740,Bus,2015,27,130,157
1258,20740,Bus,2016,12,105,117
1259,20740,Bus,2017,41,134,175
1260,20740,Bus,2018,88,98,186
1261,20940,Bus,2002,0,0,0
1262,20940,Bus,2003,0,0,0
1263,20940,Bus,2004,0,0,0
1264,20940,Bus,2005,0,0,0
1265,20940,Bus,2006,0,0,0
1266,20940,Bus,2007,0,0,0
1267,20940,Bus,2012,37,38,75
1268,20940,Bus,2013,17,4,21
1269,20940,Bus,2014,3,25,28
1270,20940,Bus,2015,20,28,48
1271,20940,Bus,2016,12,10,22
1272,20940,Bus,2017,14,4,18
1273,20940,Bus,2018,16,7,23
1274,21060,Bus,2002,0,0,0
1275,21060,Bus,2003,0,0,0
1276,21060,Bus,2004,0,0,0
1277,21060,Bus,2005,0,0,0
1278,21060,Bus,2006,0,0,0
1279,21060,Bus,2007,0,0,0
1280,21060,Bus,2012,0,0,0
1281,21060,Bus,2013,0,0,0
1282,21060,Bus,2014,0,0,0
1283,21060,Bus,2015,1,0,1
1284,21060,Bus,2016,0,0,0
1285,21060,Bus,2017,1,0,1
1286,21060,Bus,2018,1,0,1
1287,21140,Bus,2002,0,0,0
1288,21140,Bus,2003,0,0,0
1289,21140,Bus,2004,0,0,0
1290,21140,Bus,2005,0,0,0
1291,21140,Bus,2006,0,0,0
1292,21140,Bus,2007,0,0,0
1293,21140,Bus,2012,13,2,15
1294,21140,Bus,2013,3,16,19
1295,21140,Bus,2014,5,15,20
1296,21140,Bus,2015,5,12,17
1297,21140,Bus,2016,10,10,20
1298,21140,Bus,2017,12,8,20
1299,21140,Bus,2018,25,7,32
1300,21300,Bus,2002,0,0,0
1301,21300,Bus,2003,0,0,0
1302,21300,Bus,2004,0,0,0
1303,21300,Bus,2005,0,0,0
1304,21300,Bus,2006,0,0,0
1305,21300,Bus,2007,0,0,0
1306,21300,Bus,2012,0,0,0
1307,21300,Bus,2013,0,0,0
1308,21300,Bus,2014,0,0,0
1309,21300,Bus,2015,0,0,0
1310,21300,Bus,2016,0,0,0
1311,21300,Bus,2017,0,0,0
1312,21300,Bus,2018,0,0,0
1313,21340,Bus,2002,2823,1284,4107
1314,21340,Bus,2003,2106,1088,3194
1315,21340,Bus,2004,2342,1041,3383
1316,21340,Bus,2005,2150,2250,4400
1317,21340,Bus,2006,2059,402,2461
1318,21340,Bus,2007,1406,272,1678
1319,21340,Bus,2012,217,26,243
1320,21340,Bus,2013,207,59,266
1321,21340,Bus,2014,150,6,156
1322,21340,Bus,2015,87,4,91
1323,21340,Bus,2016,74,9,83
1324,21340,Bus,2017,89,12,101
1325,21340,Bus,2018,60,22,82
1326,21500,Bus,2002,185,101,286
1327,21500,Bus,2003,99,152,251
1328,21500,Bus,2004,18,22,40
1329,21500,Bus,2005,56,296,352
1330,21500,Bus,2006,70,272,342
1331,21500,Bus,2007,167,285,452
1332,21500,Bus,2012,111,268,379
1333,21500,Bus,2013,125,326,451
1334,21500,Bus,2014,257,222,479
1335,21500,Bus,2015,248,321,569
1336,21500,Bus,2016,270,263,533
1337,21500,Bus,2017,383,108,491
1338,21500,Bus,2018,321,111,432
1339,21660,Bus,2002,585,648,1233
1340,21660,Bus,2003,617,485,1102
1341,21660,Bus,2004,612,505,1117
1342,21660,Bus,2005,605,461,1066
1343,21660,Bus,2006,781,490,1271
1344,21660,Bus,2007,660,309,969
1345,21660,Bus,2012,585,442,1027
1346,21660,Bus,2013,462,206,668
1347,21660,Bus,2014,601,240,841
1348,21660,Bus,2015,621,249,870
1349,21660,Bus,2016,602,277,879
1350,21660,Bus,2017,524,281,805
1351,21660,Bus,2018,561,325,886
1352,21780,Bus,2002,352,486,838
1353,21780,Bus,2003,384,520,904
1354,21780,Bus,2004,530,479,1009
1355,21780,Bus,2005,551,498,1049
1356,21780,Bus,2006,557,512,1069
1357,21780,Bus,2007,563,572,1135
1358,21780,Bus,2012,203,120,323
1359,21780,Bus,2013,38,24,62
1360,21780,Bus,2014,34,19,53
1361,21780,Bus,2015,23,183,206
1362,21780,Bus,2016,25,17,42
1363,21780,Bus,2017,20,46,66
1364,21780,Bus,2018,19,32,51
1365,21820,Bus,2002,0,0,0
1366,21820,Bus,2003,0,0,0
1367,21820,Bus,2004,6,6,12
1368,21820,Bus,2005,6,16,22
1369,21820,Bus,2006,6,11,17
1370,21820,Bus,2007,7,22,29
1371,21820,Bus,2012,0,0,0
1372,21820,Bus,2013,0,0,0
1373,21820,Bus,2014,0,0,0
1374,21820,Bus,2015,0,0,0
1375,21820,Bus,2016,0,0,0
1376,21820,Bus,2017,0,0,0
1377,21820,Bus,2018,0,0,0
1378,22020,Bus,2002,0,0,0
1379,22020,Bus,2003,0,0,0
1380,22020,Bus,2004,0,0,0
1381,22020,Bus,2005,0,0,0
1382,22020,Bus,2006,0,0,0
1383,22020,Bus,2007,0,0,0
1384,22020,Bus,2012,58,46,104
1385,22020,Bus,2013,76,40,116
1386,22020,Bus,2014,90,37,127
1387,22020,Bus,2015,58,47,105
1388,22020,Bus,2016,60,77,137
1389,22020,Bus,2017,38,40,78
1390,22020,Bus,2018,36,106,142
1391,22180,Bus,2002,95,0,95
1392,22180,Bus,2003,15,0,15
1393,22180,Bus,2004,33,22,55
1394,22180,Bus,2005,45,13,58
1395,22180,Bus,2006,63,7,70
1396,22180,Bus,2007,75,45,120
1397,22180,Bus,2012,35,13,48
1398,22180,Bus,2013,42,29,71
1399,22180,Bus,2014,41,20,61
1400,22180,Bus,2015,47,23,70
1401,22180,Bus,2016,75,26,101
1402,22180,Bus,2017,67,15,82
1403,22180,Bus,2018,73,25,98
1404,22220,Bus,2002,2,19,21
1405,22220,Bus,2003,0,20,20
1406,22220,Bus,2004,9,14,23
1407,22220,Bus,2005,6,15,21
1408,22220,Bus,2006,14,15,29
1409,22220,Bus,2007,31,13,44
1410,22220,Bus,2012,15,12,27
1411,22220,Bus,2013,14,38,52
1412,22220,Bus,2014,35,64,99
1413,22220,Bus,2015,49,143,192
1414,22220,Bus,2016,61,121,182
1415,22220,Bus,2017,53,83,136
1416,22220,Bus,2018,23,66,89
1417,22380,Bus,2002,0,0,0
1418,22380,Bus,2003,0,0,0
1419,22380,Bus,2004,0,0,0
1420,22380,Bus,2005,0,0,0
1421,22380,Bus,2006,0,0,0
1422,22380,Bus,2007,0,0,0
1423,22380,Bus,2012,57,89,146
1424,22380,Bus,2013,114,48,162
1425,22380,Bus,2014,125,95,220
1426,22380,Bus,2015,135,69,204
1427,22380,Bus,2016,95,51,146
1428,22380,Bus,2017,97,68,165
1429,22380,Bus,2018,89,93,182
1430,22420,Bus,2002,281,942,1223
1431,22420,Bus,2003,428,124,552
1432,22420,Bus,2004,628,267,895
1433,22420,Bus,2005,772,290,1062
1434,22420,Bus,2006,759,225,984
1435,22420,Bus,2007,650,268,918
1436,22420,Bus,2012,576,75,651
1437,22420,Bus,2013,642,76,718
1438,22420,Bus,2014,653,99,752
1439,22420,Bus,2015,597,80,677
1440,22420,Bus,2016,474,88,562
1441,22420,Bus,2017,419,93,512
1442,22420,Bus,2018,512,408,920
1443,22500,Bus,2002,0,6,6
1444,22500,Bus,2003,0,5,5
1445,22500,Bus,2004,0,4,4
1446,22500,Bus,2005,0,3,3
1447,22500,Bus,2006,0,4,4
1448,22500,Bus,2007,0,3,3
1449,22500,Bus,2012,23,47,70
1450,22500,Bus,2013,19,171,190
1451,22500,Bus,2014,0,0,0
1452,22500,Bus,2015,0,0,0
1453,22500,Bus,2016,0,0,0
1454,22500,Bus,2017,0,0,0
1455,22500,Bus,2018,0,0,0
1456,22660,Bus,2002,31,37,68
1457,22660,Bus,2003,534,1527,2061
1458,22660,Bus,2004,34,127,161
1459,22660,Bus,2005,35,134,169
1460,22660,Bus,2006,112,108,220
1461,22660,Bus,2007,50,141,191
1462,22660,Bus,2012,164,109,273
1463,22660,Bus,2013,67,236,303
1464,22660,Bus,2014,64,204,268
1465,22660,Bus,2015,132,428,560
1466,22660,Bus,2016,125,253,378
1467,22660,Bus,2017,193,210,403
1468,22660,Bus,2018,203,255,458
1469,22900,Bus,2002,2,169,171
1470,22900,Bus,2003,10,123,133
1471,22900,Bus,2004,18,202,220
1472,22900,Bus,2005,20,228,248
1473,22900,Bus,2006,7,94,101
1474,22900,Bus,2007,26,189,215
1475,22900,Bus,2012,0,0,0
1476,22900,Bus,2013,0,0,0
1477,22900,Bus,2014,0,0,0
1478,22900,Bus,2015,0,0,0
1479,22900,Bus,2016,0,0,0
1480,22900,Bus,2017,0,0,0
1481,22900,Bus,2018,0,0,0
1482,23060,Bus,2002,37,100,137
1483,23060,Bus,2003,57,110,167
1484,23060,Bus,2004,0,178,178
1485,23060,Bus,2005,125,26,151
1486,23060,Bus,2006,98,40,138
1487,23060,Bus,2007,87,73,160
1488,23060,Bus,2012,54,84,138
1489,23060,Bus,2013,54,84,138
1490,23060,Bus,2014,38,37,75
1491,23060,Bus,2015,42,139,181
1492,23060,Bus,2016,18,363,381
1493,23060,Bus,2017,19,258,277
1494,23060,Bus,2018,22,309,331
1495,23420,Bus,2002,809,426,1235
1496,23420,Bus,2003,789,347,1136
1497,23420,Bus,2004,870,308,1178
1498,23420,Bus,2005,812,278,1090
1499,23420,Bus,2006,903,290,1193
1500,23420,Bus,2007,740,251,991
1501,23420,Bus,2012,509,103,612
1502,23420,Bus,2013,409,113,522
1503,23420,Bus,2014,468,178,646
1504,23420,Bus,2015,506,156,662
1505,23420,Bus,2016,642,179,821
1506,23420,Bus,2017,372,89,461
1507,23420,Bus,2018,226,154,380
1508,23540,Bus,2002,313,213,526
1509,23540,Bus,2003,530,266,796
1510,23540,Bus,2004,543,247,790
1511,23540,Bus,2005,421,214,635
1512,23540,Bus,2006,503,301,804
1513,23540,Bus,2007,363,442,805
1514,23540,Bus,2012,130,323,453
1515,23540,Bus,2013,115,276,391
1516,23540,Bus,2014,122,267,389
1517,23540,Bus,2015,118,253,371
1518,23540,Bus,2016,102,257,359
1519,23540,Bus,2017,192,261,453
1520,23540,Bus,2018,264,620,884
1521,23580,Bus,2002,0,0,0
1522,23580,Bus,2003,0,0,0
1523,23580,Bus,2004,0,0,0
1524,23580,Bus,2005,0,0,0
1525,23580,Bus,2006,0,0,0
1526,23580,Bus,2007,0,0,0
1527,23580,Bus,2012,8,12,20
1528,23580,Bus,2013,6,5,11
1529,23580,Bus,2014,0,8,8
1530,23580,Bus,2015,0,0,0
1531,23580,Bus,2016,0,0,0
1532,23580,Bus,2017,0,0,0
1533,23580,Bus,2018,0,0,0
1534,24220,Bus,2002,22,1,23
1535,24220,Bus,2003,13,3,16
1536,24220,Bus,2004,4,0,4
1537,24220,Bus,2005,2,0,2
1538,24220,Bus,2006,2,1,3
1539,24220,Bus,2007,52,102,154
1540,24220,Bus,2012,6,71,77
1541,24220,Bus,2013,10,83,93
1542,24220,Bus,2014,8,111,119
1543,24220,Bus,2015,4,143,147
1544,24220,Bus,2016,2,115,117
1545,24220,Bus,2017,5,78,83
1546,24220,Bus,2018,4,98,102
1547,24300,Bus,2002,0,0,0
1548,24300,Bus,2003,0,0,0
1549,24300,Bus,2004,0,0,0
1550,24300,Bus,2005,0,0,0
1551,24300,Bus,2006,0,0,0
1552,24300,Bus,2007,0,0,0
1553,24300,Bus,2012,139,35,174
1554,24300,Bus,2013,99,32,131
1555,24300,Bus,2014,72,6,78
1556,24300,Bus,2015,94,10,104
1557,24300,Bus,2016,0,0,0
1558,24300,Bus,2017,0,0,0
1559,24300,Bus,2018,0,0,0
1560,24340,Bus,2002,400,351,751
1561,24340,Bus,2003,260,150,410
1562,24340,Bus,2004,639,377,1016
1563,24340,Bus,2005,1088,336,1424
1564,24340,Bus,2006,1205,376,1581
1565,24340,Bus,2007,364,961,1325
1566,24340,Bus,2012,115,1051,1166
1567,24340,Bus,2013,390,1448,1838
1568,24340,Bus,2014,682,1295,1977
1569,24340,Bus,2015,197,1900,2097
1570,24340,Bus,2016,270,669,939
1571,24340,Bus,2017,95,523,618
1572,24340,Bus,2018,262,313,575
1573,24500,Bus,2002,110,54,164
1574,24500,Bus,2003,132,15,147
1575,24500,Bus,2004,0,0,0
1576,24500,Bus,2005,0,0,0
1577,24500,Bus,2006,3,0,3
1578,24500,Bus,2007,0,74,74
1579,24500,Bus,2012,61,8,69
1580,24500,Bus,2013,54,11,65
1581,24500,Bus,2014,54,2,56
1582,24500,Bus,2015,47,1,48
1583,24500,Bus,2016,103,13,116
1584,24500,Bus,2017,120,5,125
1585,24500,Bus,2018,133,9,142
1586,24540,Bus,2002,116,35,151
1587,24540,Bus,2003,114,41,155
1588,24540,Bus,2004,74,17,91
1589,24540,Bus,2005,68,15,83
1590,24540,Bus,2006,71,15,86
1591,24540,Bus,2007,82,20,102
1592,24540,Bus,2012,0,0,0
1593,24540,Bus,2013,0,0,0
1594,24540,Bus,2014,0,0,0
1595,24540,Bus,2015,0,0,0
1596,24540,Bus,2016,0,0,0
1597,24540,Bus,2017,0,0,0
1598,24540,Bus,2018,0,0,0
1599,24580,Bus,2002,122,181,303
1600,24580,Bus,2003,118,204,322
1601,24580,Bus,2004,86,176,262
1602,24580,Bus,2005,74,162,236
1603,24580,Bus,2006,79,183,262
1604,24580,Bus,2007,85,95,180
1605,24580,Bus,2012,37,74,111
1606,24580,Bus,2013,40,202,242
1607,24580,Bus,2014,109,199,308
1608,24580,Bus,2015,179,146,325
1609,24580,Bus,2016,64,191,255
1610,24580,Bus,2017,53,200,253
1611,24580,Bus,2018,35,119,154
1612,24660,Bus,2002,91,43,134
1613,24660,Bus,2003,68,67,135
1614,24660,Bus,2004,88,55,143
1615,24660,Bus,2005,39,34,73
1616,24660,Bus,2006,80,63,143
1617,24660,Bus,2007,31,78,109
1618,24660,Bus,2012,258,219,477
1619,24660,Bus,2013,255,223,478
1620,24660,Bus,2014,78,229,307
1621,24660,Bus,2015,63,221,284
1622,24660,Bus,2016,106,142,248
1623,24660,Bus,2017,171,190,361
1624,24660,Bus,2018,130,216,346
1625,24860,Bus,2002,154,116,270
1626,24860,Bus,2003,252,312,564
1627,24860,Bus,2004,249,85,334
1628,24860,Bus,2005,163,52,215
1629,24860,Bus,2006,162,257,419
1630,24860,Bus,2007,207,425,632
1631,24860,Bus,2012,20,728,748
1632,24860,Bus,2013,63,269,332
1633,24860,Bus,2014,163,425,588
1634,24860,Bus,2015,29,1240,1269
1635,24860,Bus,2016,492,530,1022
1636,24860,Bus,2017,47,1030,1077
1637,24860,Bus,2018,210,22,232
1638,25060,Bus,2002,101,80,181
1639,25060,Bus,2003,156,191,347
1640,25060,Bus,2004,128,145,273
1641,25060,Bus,2005,120,199,319
1642,25060,Bus,2006,104,77,181
1643,25060,Bus,2007,96,84,180
1644,25060,Bus,2012,142,398,540
1645,25060,Bus,2013,230,458,688
1646,25060,Bus,2014,241,374,615
1647,25060,Bus,2015,225,356,581
1648,25060,Bus,2016,211,137,348
1649,25060,Bus,2017,151,210,361
1650,25060,Bus,2018,128,242,370
1651,25180,Bus,2002,13,30,43
1652,25180,Bus,2003,2,48,50
1653,25180,Bus,2004,4,61,65
1654,25180,Bus,2005,3,43,46
1655,25180,Bus,2006,9,51,60
1656,25180,Bus,2007,3,48,51
1657,25180,Bus,2012,0,0,0
1658,25180,Bus,2013,0,0,0
1659,25180,Bus,2014,0,0,0
1660,25180,Bus,2015,0,0,0
1661,25180,Bus,2016,0,0,0
1662,25180,Bus,2017,0,0,0
1663,25180,Bus,2018,0,0,0
1664,25260,Bus,2002,0,0,0
1665,25260,Bus,2003,0,0,0
1666,25260,Bus,2004,0,0,0
1667,25260,Bus,2005,0,0,0
1668,25260,Bus,2006,0,0,0
1669,25260,Bus,2007,0,0,0
1670,25260,Bus,2012,9,15,24
1671,25260,Bus,2013,17,17,34
1672,25260,Bus,2014,24,6,30
1673,25260,Bus,2015,24,12,36
1674,25260,Bus,2016,43,9,52
1675,25260,Bus,2017,19,15,34
1676,25260,Bus,2018,77,21,98
1677,25420,Bus,2002,137,342,479
1678,25420,Bus,2003,258,271,529
1679,25420,Bus,2004,240,215,455
1680,25420,Bus,2005,290,224,514
1681,25420,Bus,2006,280,275,555
1682,25420,Bus,2007,286,242,528
1683,25420,Bus,2012,457,187,644
1684,25420,Bus,2013,244,143,387
1685,25420,Bus,2014,159,238,397
1686,25420,Bus,2015,120,343,463
1687,25420,Bus,2016,242,148,390
1688,25420,Bus,2017,236,145,381
1689,25420,Bus,2018,314,135,449
1690,25500,Bus,2002,0,0,0
1691,25500,Bus,2003,0,0,0
1692,25500,Bus,2004,0,0,0
1693,25500,Bus,2005,36,0,36
1694,25500,Bus,2006,6,53,59
1695,25500,Bus,2007,32,71,103
1696,25500,Bus,2012,16,61,77
1697,25500,Bus,2013,17,48,65
1698,25500,Bus,2014,6,46,52
1699,25500,Bus,2015,54,29,83
1700,25500,Bus,2016,75,19,94
1701,25500,Bus,2017,75,18,93
1702,25500,Bus,2018,84,37,121
1703,25540,Bus,2002,3324,3176,6500
1704,25540,Bus,2003,3742,3964,7706
1705,25540,Bus,2004,3710,4177,7887
1706,25540,Bus,2005,3743,4860,8603
1707,25540,Bus,2006,3825,6004,9829
1708,25540,Bus,2007,3393,5703,9096
1709,25540,Bus,2012,3085,6643,9728
1710,25540,Bus,2013,2559,6516,9075
1711,25540,Bus,2014,2224,8784,11008
1712,25540,Bus,2015,2494,9161,11655
1713,25540,Bus,2016,2413,9766,12179
1714,25540,Bus,2017,2219,8524,10743
1715,25540,Bus,2018,2351,7852,10203
1716,25540,Rail,2002,3,6,9
1717,25540,Rail,2003,3,3,6
1718,25540,Rail,2004,3,4,7
1719,25540,Rail,2005,18,11,29
1720,25540,Rail,2006,3,28,31
1721,25540,Rail,2007,4,33,37
1722,25540,Rail,2012,48,121,169
1723,25540,Rail,2013,36,89,125
1724,25540,Rail,2014,30,95,125
1725,25540,Rail,2015,118,91,209
1726,25540,Rail,2016,80,72,152
1727,25540,Rail,2017,56,77,133
1728,25540,Rail,2018,111,13,124
1729,25860,Bus,2002,0,0,0
1730,25860,Bus,2003,0,0,0
1731,25860,Bus,2004,0,0,0
1732,25860,Bus,2005,0,0,0
1733,25860,Bus,2006,0,0,0
1734,25860,Bus,2007,0,0,0
1735,25860,Bus,2012,7,16,23
1736,25860,Bus,2013,7,12,19
1737,25860,Bus,2014,12,1,13
1738,25860,Bus,2015,5,1,6
1739,25860,Bus,2016,6,1,7
1740,25860,Bus,2017,9,1,10
1741,25860,Bus,2018,25,6,31
1742,26100,Bus,2002,441,362,803
1743,26100,Bus,2003,331,170,501
1744,26100,Bus,2004,717,396,1113
1745,26100,Bus,2005,1150,363,1513
1746,26100,Bus,2006,1290,400,1690
1747,26100,Bus,2007,412,998,1410
1748,26100,Bus,2012,132,1123,1255
1749,26100,Bus,2013,412,1536,1948
1750,26100,Bus,2014,696,1385,2081
1751,26100,Bus,2015,204,2013,2217
1752,26100,Bus,2016,292,752,1044
1753,26100,Bus,2017,121,571,692
1754,26100,Bus,2018,297,336,633
1755,26380,Bus,2002,16,12,28
1756,26380,Bus,2003,14,6,20
1757,26380,Bus,2004,0,0,0
1758,26380,Bus,2005,0,0,0
1759,26380,Bus,2006,0,0,0
1760,26380,Bus,2007,0,0,0
1761,26380,Bus,2012,0,0,0
1762,26380,Bus,2013,0,0,0
1763,26380,Bus,2014,0,0,0
1764,26380,Bus,2015,0,0,0
1765,26380,Bus,2016,0,0,0
1766,26380,Bus,2017,0,0,0
1767,26380,Bus,2018,0,0,0
1768,26420,Bus,2002,4432,3635,8067
1769,26420,Bus,2003,7394,6561,13955
1770,26420,Bus,2004,7993,5008,13001
1771,26420,Bus,2005,8285,3070,11355
1772,26420,Bus,2006,6976,3162,10138
1773,26420,Bus,2007,6258,3401,9659
1774,26420,Bus,2012,4449,1990,6439
1775,26420,Bus,2013,4512,1945,6457
1776,26420,Bus,2014,4091,1680,5771
1777,26420,Bus,2015,4164,1770,5934
1778,26420,Bus,2016,4137,2039,6176
1779,26420,Bus,2017,3904,1719,5623
1780,26420,Bus,2018,3917,1657,5574
1781,26420,Rail,2002,0,0,0
1782,26420,Rail,2003,0,0,0
1783,26420,Rail,2004,11,108,119
1784,26420,Rail,2005,5,117,122
1785,26420,Rail,2006,11,99,110
1786,26420,Rail,2007,16,84,100
1787,26420,Rail,2012,8,26,34
1788,26420,Rail,2013,17,32,49
1789,26420,Rail,2014,28,30,58
1790,26420,Rail,2015,28,42,70
1791,26420,Rail,2016,33,41,74
1792,26420,Rail,2017,29,31,60
1793,26420,Rail,2018,20,26,46
1794,26580,Bus,2002,0,403,403
1795,26580,Bus,2003,0,346,346
1796,26580,Bus,2004,2,326,328
1797,26580,Bus,2005,0,269,269
1798,26580,Bus,2006,0,198,198
1799,26580,Bus,2007,0,352,352
1800,26580,Bus,2012,8,337,345
1801,26580,Bus,2013,5,296,301
1802,26580,Bus,2014,92,24,116
1803,26580,Bus,2015,2,224,226
1804,26580,Bus,2016,2,275,277
1805,26580,Bus,2017,2,356,358
1806,26580,Bus,2018,12,296,308
1807,26620,Bus,2002,15,7,22
1808,26620,Bus,2003,42,71,113
1809,26620,Bus,2004,53,51,104
1810,26620,Bus,2005,65,100,165
1811,26620,Bus,2006,19,244,263
1812,26620,Bus,2007,16,233,249
1813,26620,Bus,2012,31,126,157
1814,26620,Bus,2013,24,130,154
1815,26620,Bus,2014,22,158,180
1816,26620,Bus,2015,20,144,164
1817,26620,Bus,2016,35,162,197
1818,26620,Bus,2017,63,148,211
1819,26620,Bus,2018,87,124,211
1820,26820,Bus,2002,1,0,1
1821,26820,Bus,2003,0,0,0
1822,26820,Bus,2004,0,0,0
1823,26820,Bus,2005,0,0,0
1824,26820,Bus,2006,68,20,88
1825,26820,Bus,2007,0,0,0
1826,26820,Bus,2012,0,0,0
1827,26820,Bus,2013,0,0,0
1828,26820,Bus,2014,0,0,0
1829,26820,Bus,2015,0,0,0
1830,26820,Bus,2016,0,0,0
1831,26820,Bus,2017,0,0,0
1832,26820,Bus,2018,0,0,0
1833,26900,Bus,2002,473,0,473
1834,26900,Bus,2003,579,0,579
1835,26900,Bus,2004,315,0,315
1836,26900,Bus,2005,351,0,351
1837,26900,Bus,2006,311,8,319
1838,26900,Bus,2007,318,78,396
1839,26900,Bus,2012,2011,751,2762
1840,26900,Bus,2013,1748,498,2246
1841,26900,Bus,2014,1476,344,1820
1842,26900,Bus,2015,1453,378,1831
1843,26900,Bus,2016,1578,378,1956
1844,26900,Bus,2017,1225,43,1268
1845,26900,Bus,2018,1437,393,1830
1846,26980,Bus,2002,22,94,116
1847,26980,Bus,2003,30,266,296
1848,26980,Bus,2004,49,81,130
1849,26980,Bus,2005,45,137,182
1850,26980,Bus,2006,50,265,315
1851,26980,Bus,2007,56,276,332
1852,26980,Bus,2012,67,127,194
1853,26980,Bus,2013,64,146,210
1854,26980,Bus,2014,45,124,169
1855,26980,Bus,2015,46,130,176
1856,26980,Bus,2016,47,128,175
1857,26980,Bus,2017,60,163,223
1858,26980,Bus,2018,52,196,248
1859,27060,Bus,2002,320,112,432
1860,27060,Bus,2003,151,376,527
1861,27060,Bus,2004,375,179,554
1862,27060,Bus,2005,375,300,675
1863,27060,Bus,2006,326,307,633
1864,27060,Bus,2007,174,451,625
1865,27060,Bus,2012,196,186,382
1866,27060,Bus,2013,214,169,383
1867,27060,Bus,2014,306,204,510
1868,27060,Bus,2015,221,168,389
1869,27060,Bus,2016,140,369,509
1870,27060,Bus,2017,43,253,296
1871,27060,Bus,2018,64,324,388
1872,27100,Bus,2002,103,111,214
1873,27100,Bus,2003,236,104,340
1874,27100,Bus,2004,49,18,67
1875,27100,Bus,2005,35,8,43
1876,27100,Bus,2006,182,90,272
1877,27100,Bus,2007,31,12,43
1878,27100,Bus,2012,41,38,79
1879,27100,Bus,2013,63,33,96
1880,27100,Bus,2014,91,47,138
1881,27100,Bus,2015,86,50,136
1882,27100,Bus,2016,113,28,141
1883,27100,Bus,2017,158,49,207
1884,27100,Bus,2018,54,150,204
1885,27140,Bus,2002,257,76,333
1886,27140,Bus,2003,297,42,339
1887,27140,Bus,2004,247,27,274
1888,27140,Bus,2005,359,47,406
1889,27140,Bus,2006,434,26,460
1890,27140,Bus,2007,390,25,415
1891,27140,Bus,2012,25,51,76
1892,27140,Bus,2013,93,108,201
1893,27140,Bus,2014,103,188,291
1894,27140,Bus,2015,6,360,366
1895,27140,Bus,2016,14,1185,1199
1896,27140,Bus,2017,8,1311,1319
1897,27140,Bus,2018,13,1422,1435
1898,27180,Bus,2002,45,84,129
1899,27180,Bus,2003,44,79,123
1900,27180,Bus,2004,51,43,94
1901,27180,Bus,2005,36,63,99
1902,27180,Bus,2006,48,112,160
1903,27180,Bus,2007,41,113,154
1904,27180,Bus,2012,77,82,159
1905,27180,Bus,2013,70,65,135
1906,27180,Bus,2014,87,70,157
1907,27180,Bus,2015,67,98,165
1908,27180,Bus,2016,78,67,145
1909,27180,Bus,2017,96,82,178
1910,27180,Bus,2018,94,62,156
1911,27260,Bus,2002,637,180,817
1912,27260,Bus,2003,854,145,999
1913,27260,Bus,2004,625,94,719
1914,27260,Bus,2005,440,67,507
1915,27260,Bus,2006,524,75,599
1916,27260,Bus,2007,591,105,696
1917,27260,Bus,2012,370,359,729
1918,27260,Bus,2013,169,232,401
1919,27260,Bus,2014,80,528,608
1920,27260,Bus,2015,92,571,663
1921,27260,Bus,2016,90,699,789
1922,27260,Bus,2017,94,714,808
1923,27260,Bus,2018,126,691,817
1924,27260,Rail,2002,15,17,32
1925,27260,Rail,2003,30,27,57
1926,27260,Rail,2004,32,27,59
1927,27260,Rail,2005,20,7,27
1928,27260,Rail,2006,22,9,31
1929,27260,Rail,2007,7,3,10
1930,27260,Rail,2012,11,8,19
1931,27260,Rail,2013,7,4,11
1932,27260,Rail,2014,8,4,12
1933,27260,Rail,2015,10,12,22
1934,27260,Rail,2016,5,5,10
1935,27260,Rail,2017,3,5,8
1936,27260,Rail,2018,15,2,17
1937,27620,Bus,2002,0,0,0
1938,27620,Bus,2003,0,0,0
1939,27620,Bus,2004,0,0,0
1940,27620,Bus,2005,120,209,329
1941,27620,Bus,2006,3,29,32
1942,27620,Bus,2007,5,34,39
1943,27620,Bus,2012,0,0,0
1944,27620,Bus,2013,0,0,0
1945,27620,Bus,2014,0,0,0
1946,27620,Bus,2015,0,0,0
1947,27620,Bus,2016,0,0,0
1948,27620,Bus,2017,0,0,0
1949,27620,Bus,2018,0,0,0
1950,27740,Bus,2002,3,2,5
1951,27740,Bus,2003,2,3,5
1952,27740,Bus,2004,2,4,6
1953,27740,Bus,2005,2,3,5
1954,27740,Bus,2006,1,4,5
1955,27740,Bus,2007,1,2,3
1956,27740,Bus,2012,0,0,0
1957,27740,Bus,2013,0,0,0
1958,27740,Bus,2014,0,0,0
1959,27740,Bus,2015,0,0,0
1960,27740,Bus,2016,0,0,0
1961,27740,Bus,2017,0,0,0
1962,27740,Bus,2018,0,0,0
1963,27780,Bus,2002,88,13,101
1964,27780,Bus,2003,81,88,169
1965,27780,Bus,2004,7,18,25
1966,27780,Bus,2005,8,16,24
1967,27780,Bus,2006,25,32,57
1968,27780,Bus,2007,57,21,78
1969,27780,Bus,2012,173,14,187
1970,27780,Bus,2013,129,63,192
1971,27780,Bus,2014,62,122,184
1972,27780,Bus,2015,233,299,532
1973,27780,Bus,2016,201,274,475
1974,27780,Bus,2017,123,365,488
1975,27780,Bus,2018,276,191,467
1976,27780,Rail,2002,0,0,0
1977,27780,Rail,2003,0,1,1
1978,27780,Rail,2004,0,1,1
1979,27780,Rail,2005,0,1,1
1980,27780,Rail,2006,0,1,1
1981,27780,Rail,2007,0,1,1
1982,27780,Rail,2012,1,2,3
1983,27780,Rail,2013,4,0,4
1984,27780,Rail,2014,6,0,6
1985,27780,Rail,2015,9,0,9
1986,27780,Rail,2016,8,0,8
1987,27780,Rail,2017,12,0,12
1988,27780,Rail,2018,0,0,0
1989,28020,Bus,2002,507,423,930
1990,28020,Bus,2003,207,625,832
1991,28020,Bus,2004,296,612,908
1992,28020,Bus,2005,362,545,907
1993,28020,Bus,2006,206,329,535
1994,28020,Bus,2007,273,511,784
1995,28020,Bus,2012,39,592,631
1996,28020,Bus,2013,24,503,527
1997,28020,Bus,2014,57,438,495
1998,28020,Bus,2015,29,522,551
1999,28020,Bus,2016,33,673,706
2000,28020,Bus,2017,19,742,761
2001,28020,Bus,2018,35,915,950
2002,28100,Bus,2002,0,0,0
2003,28100,Bus,2003,0,0,0
2004,28100,Bus,2004,0,0,0
2005,28100,Bus,2005,0,0,0
2006,28100,Bus,2006,0,0,0
2007,28100,Bus,2007,0,0,0
2008,28100,Bus,2012,140,389,529
2009,28100,Bus,2013,138,366,504
2010,28100,Bus,2014,123,361,484
2011,28100,Bus,2015,133,385,518
2012,28100,Bus,2016,133,563,696
2013,28100,Bus,2017,247,489,736
2014,28100,Bus,2018,257,549,806
2015,28140,Bus,2002,872,900,1772
2016,28140,Bus,2003,687,295,982
2017,28140,Bus,2004,824,378,1202
2018,28140,Bus,2005,750,243,993
2019,28140,Bus,2006,512,110,622
2020,28140,Bus,2007,689,51,740
2021,28140,Bus,2012,583,69,652
2022,28140,Bus,2013,571,99,670
2023,28140,Bus,2014,570,87,657
2024,28140,Bus,2015,751,138,889
2025,28140,Bus,2016,678,157,835
2026,28140,Bus,2017,693,127,820
2027,28140,Bus,2018,601,148,749
2028,28420,Bus,2002,237,12,249
2029,28420,Bus,2003,248,13,261
2030,28420,Bus,2004,0,0,0
2031,28420,Bus,2005,206,10,216
2032,28420,Bus,2006,182,9,191
2033,28420,Bus,2007,149,7,156
2034,28420,Bus,2012,24,17,41
2035,28420,Bus,2013,35,2,37
2036,28420,Bus,2014,29,1,30
2037,28420,Bus,2015,31,0,31
2038,28420,Bus,2016,87,87,174
2039,28420,Bus,2017,62,116,178
2040,28420,Bus,2018,72,71,143
2041,28660,Bus,2002,39,35,74
2042,28660,Bus,2003,99,121,220
2043,28660,Bus,2004,51,39,90
2044,28660,Bus,2005,39,49,88
2045,28660,Bus,2006,26,35,61
2046,28660,Bus,2007,27,43,70
2047,28660,Bus,2012,51,50,101
2048,28660,Bus,2013,139,50,189
2049,28660,Bus,2014,66,6,72
2050,28660,Bus,2015,94,22,116
2051,28660,Bus,2016,75,5,80
2052,28660,Bus,2017,49,5,54
2053,28660,Bus,2018,53,5,58
2054,28700,Bus,2002,2,2,4
2055,28700,Bus,2003,0,1,1
2056,28700,Bus,2004,3,3,6
2057,28700,Bus,2005,0,0,0
2058,28700,Bus,2006,0,0,0
2059,28700,Bus,2007,0,0,0
2060,28700,Bus,2012,0,0,0
2061,28700,Bus,2013,0,0,0
2062,28700,Bus,2014,0,0,0
2063,28700,Bus,2015,0,0,0
2064,28700,Bus,2016,0,0,0
2065,28700,Bus,2017,0,0,0
2066,28700,Bus,2018,0,0,0
2067,28940,Bus,2002,397,339,736
2068,28940,Bus,2003,365,339,704
2069,28940,Bus,2004,479,351,830
2070,28940,Bus,2005,616,463,1079
2071,28940,Bus,2006,327,312,639
2072,28940,Bus,2007,166,254,420
2073,28940,Bus,2012,471,87,558
2074,28940,Bus,2013,380,123,503
2075,28940,Bus,2014,231,90,321
2076,28940,Bus,2015,253,42,295
2077,28940,Bus,2016,197,21,218
2078,28940,Bus,2017,280,24,304
2079,28940,Bus,2018,319,33,352
2080,29020,Bus,2002,0,0,0
2081,29020,Bus,2003,0,0,0
2082,29020,Bus,2004,0,0,0
2083,29020,Bus,2005,0,0,0
2084,29020,Bus,2006,0,0,0
2085,29020,Bus,2007,0,0,0
2086,29020,Bus,2012,6,4,10
2087,29020,Bus,2013,6,1,7
2088,29020,Bus,2014,2,5,7
2089,29020,Bus,2015,5,0,5
2090,29020,Bus,2016,1,0,1
2091,29020,Bus,2017,1,0,1
2092,29020,Bus,2018,8,3,11
2093,29100,Bus,2002,15,29,44
2094,29100,Bus,2003,13,31,44
2095,29100,Bus,2004,10,25,35
2096,29100,Bus,2005,15,24,39
2097,29100,Bus,2006,13,27,40
2098,29100,Bus,2007,13,30,43
2099,29100,Bus,2012,62,42,104
2100,29100,Bus,2013,58,73,131
2101,29100,Bus,2014,107,114,221
2102,29100,Bus,2015,54,136,190
2103,29100,Bus,2016,89,128,217
2104,29100,Bus,2017,103,219,322
2105,29100,Bus,2018,122,180,302
2106,29140,Bus,2002,24,53,77
2107,29140,Bus,2003,10,64,74
2108,29140,Bus,2004,9,50,59
2109,29140,Bus,2005,9,99,108
2110,29140,Bus,2006,15,98,113
2111,29140,Bus,2007,8,71,79
2112,29140,Bus,2012,7,0,7
2113,29140,Bus,2013,21,3,24
2114,29140,Bus,2014,17,0,17
2115,29140,Bus,2015,4,11,15
2116,29140,Bus,2016,23,12,35
2117,29140,Bus,2017,17,16,33
2118,29140,Bus,2018,17,2,19
2119,29180,Bus,2002,23,965,988
2120,29180,Bus,2003,22,319,341
2121,29180,Bus,2004,12,396,408
2122,29180,Bus,2005,19,432,451
2123,29180,Bus,2006,23,453,476
2124,29180,Bus,2007,12,439,451
2125,29180,Bus,2012,45,439,484
2126,29180,Bus,2013,41,239,280
2127,29180,Bus,2014,38,467,505
2128,29180,Bus,2015,31,554,585
2129,29180,Bus,2016,30,348,378
2130,29180,Bus,2017,36,357,393
2131,29180,Bus,2018,44,369,413
2132,29460,Bus,2002,85,126,211
2133,29460,Bus,2003,28,280,308
2134,29460,Bus,2004,71,130,201
2135,29460,Bus,2005,262,223,485
2136,29460,Bus,2006,240,200,440
2137,29460,Bus,2007,191,352,543
2138,29460,Bus,2012,457,850,1307
2139,29460,Bus,2013,375,464,839
2140,29460,Bus,2014,362,215,577
2141,29460,Bus,2015,298,127,425
2142,29460,Bus,2016,56,318,374
2143,29460,Bus,2017,262,13,275
2144,29460,Bus,2018,215,1,216
2145,29540,Bus,2002,244,143,387
2146,29540,Bus,2003,341,199,540
2147,29540,Bus,2004,222,185,407
2148,29540,Bus,2005,230,285,515
2149,29540,Bus,2006,255,274,529
2150,29540,Bus,2007,206,193,399
2151,29540,Bus,2012,169,158,327
2152,29540,Bus,2013,154,123,277
2153,29540,Bus,2014,203,176,379
2154,29540,Bus,2015,260,226,486
2155,29540,Bus,2016,266,158,424
2156,29540,Bus,2017,0,0,0
2157,29540,Bus,2018,0,0,0
2158,29620,Bus,2002,189,53,242
2159,29620,Bus,2003,177,102,279
2160,29620,Bus,2004,216,130,346
2161,29620,Bus,2005,296,166,462
2162,29620,Bus,2006,204,152,356
2163,29620,Bus,2007,239,149,388
2164,29620,Bus,2012,361,176,537
2165,29620,Bus,2013,233,99,332
2166,29620,Bus,2014,456,147,603
2167,29620,Bus,2015,368,89,457
2168,29620,Bus,2016,491,71,562
2169,29620,Bus,2017,403,35,438
2170,29620,Bus,2018,304,95,399
2171,29700,Bus,2002,122,495,617
2172,29700,Bus,2003,125,485,610
2173,29700,Bus,2004,1544,1082,2626
2174,29700,Bus,2005,2294,2455,4749
2175,29700,Bus,2006,364,0,364
2176,29700,Bus,2007,390,0,390
2177,29700,Bus,2012,254,126,380
2178,29700,Bus,2013,97,137,234
2179,29700,Bus,2014,84,117,201
2180,29700,Bus,2015,78,114,192
2181,29700,Bus,2016,60,78,138
2182,29700,Bus,2017,46,58,104
2183,29700,Bus,2018,30,39,69
2184,29740,Bus,2002,125,120,245
2185,29740,Bus,2003,180,130,310
2186,29740,Bus,2004,5,65,70
2187,29740,Bus,2005,3,173,176
2188,29740,Bus,2006,5,145,150
2189,29740,Bus,2007,22,22,44
2190,29740,Bus,2012,0,0,0
2191,29740,Bus,2013,0,0,0
2192,29740,Bus,2014,0,0,0
2193,29740,Bus,2015,0,0,0
2194,29740,Bus,2016,0,0,0
2195,29740,Bus,2017,0,0,0
2196,29740,Bus,2018,0,0,0
2197,29820,Bus,2002,0,0,0
2198,29820,Bus,2003,0,0,0
2199,29820,Bus,2004,0,0,0
2200,29820,Bus,2005,0,0,0
2201,29820,Bus,2006,0,0,0
2202,29820,Bus,2007,0,0,0
2203,29820,Bus,2012,1170,41,1211
2204,29820,Bus,2013,1642,92,1734
2205,29820,Bus,2014,1461,13,1474
2206,29820,Bus,2015,826,840,1666
2207,29820,Bus,2016,1197,501,1698
2208,29820,Bus,2017,811,409,1220
2209,29820,Bus,2018,821,319,1140
2210,29820,Rail,2002,0,0,0
2211,29820,Rail,2003,0,0,0
2212,29820,Rail,2004,0,0,0
2213,29820,Rail,2005,0,0,0
2214,29820,Rail,2006,0,0,0
2215,29820,Rail,2007,0,0,0
2216,29820,Rail,2012,13,24,37
2217,29820,Rail,2013,22,47,69
2218,29820,Rail,2014,43,18,61
2219,29820,Rail,2015,94,142,236
2220,29820,Rail,2016,102,133,235
2221,29820,Rail,2017,92,122,214
2222,29820,Rail,2018,0,0,0
2223,29940,Bus,2002,0,0,0
2224,29940,Bus,2003,0,0,0
2225,29940,Bus,2004,0,0,0
2226,29940,Bus,2005,0,0,0
2227,29940,Bus,2006,0,0,0
2228,29940,Bus,2007,0,0,0
2229,29940,Bus,2012,36,33,69
2230,29940,Bus,2013,37,42,79
2231,29940,Bus,2014,63,53,116
2232,29940,Bus,2015,32,68,100
2233,29940,Bus,2016,13,107,120
2234,29940,Bus,2017,18,102,120
2235,29940,Bus,2018,40,78,118
2236,30020,Bus,2002,0,0,0
2237,30020,Bus,2003,0,0,0
2238,30020,Bus,2004,8,6,14
2239,30020,Bus,2005,12,10,22
2240,30020,Bus,2006,20,9,29
2241,30020,Bus,2007,29,12,41
2242,30020,Bus,2012,0,0,0
2243,30020,Bus,2013,0,0,0
2244,30020,Bus,2014,0,0,0
2245,30020,Bus,2015,0,0,0
2246,30020,Bus,2016,0,0,0
2247,30020,Bus,2017,0,0,0
2248,30020,Bus,2018,0,0,0
2249,30140,Bus,2002,0,0,0
2250,30140,Bus,2003,0,0,0
2251,30140,Bus,2004,0,0,0
2252,30140,Bus,2005,0,0,0
2253,30140,Bus,2006,17,26,43
2254,30140,Bus,2007,11,24,35
2255,30140,Bus,2012,11,16,27
2256,30140,Bus,2013,14,8,22
2257,30140,Bus,2014,10,2,12
2258,30140,Bus,2015,7,3,10
2259,30140,Bus,2016,3,6,9
2260,30140,Bus,2017,9,10,19
2261,30140,Bus,2018,10,9,19
2262,30340,Bus,2002,55,61,116
2263,30340,Bus,2003,26,17,43
2264,30340,Bus,2004,6,18,24
2265,30340,Bus,2005,23,112,135
2266,30340,Bus,2006,12,55,67
2267,30340,Bus,2007,17,36,53
2268,30340,Bus,2012,0,0,0
2269,30340,Bus,2013,0,0,0
2270,30340,Bus,2014,0,0,0
2271,30340,Bus,2015,0,0,0
2272,30340,Bus,2016,53,126,179
2273,30340,Bus,2017,13,47,60
2274,30340,Bus,2018,17,9,26
2275,30460,Bus,2002,607,327,934
2276,30460,Bus,2003,313,679,992
2277,30460,Bus,2004,212,809,1021
2278,30460,Bus,2005,230,404,634
2279,30460,Bus,2006,227,422,649
2280,30460,Bus,2007,1045,235,1280
2281,30460,Bus,2012,446,275,721
2282,30460,Bus,2013,524,186,710
2283,30460,Bus,2014,400,135,535
2284,30460,Bus,2015,479,148,627
2285,30460,Bus,2016,345,187,532
2286,30460,Bus,2017,267,80,347
2287,30460,Bus,2018,319,64,383
2288,30620,Bus,2002,0,0,0
2289,30620,Bus,2003,0,0,0
2290,30620,Bus,2004,0,0,0
2291,30620,Bus,2005,0,0,0
2292,30620,Bus,2006,0,0,0
2293,30620,Bus,2007,0,0,0
2294,30620,Bus,2012,112,0,112
2295,30620,Bus,2013,0,0,0
2296,30620,Bus,2014,0,0,0
2297,30620,Bus,2015,0,0,0
2298,30620,Bus,2016,0,0,0
2299,30620,Bus,2017,0,0,0
2300,30620,Bus,2018,0,0,0
2301,30700,Bus,2002,199,275,474
2302,30700,Bus,2003,146,248,394
2303,30700,Bus,2004,158,167,325
2304,30700,Bus,2005,118,156,274
2305,30700,Bus,2006,182,168,350
2306,30700,Bus,2007,161,166,327
2307,30700,Bus,2012,143,131,274
2308,30700,Bus,2013,139,104,243
2309,30700,Bus,2014,174,147,321
2310,30700,Bus,2015,170,177,347
2311,30700,Bus,2016,193,170,363
2312,30700,Bus,2017,308,169,477
2313,30700,Bus,2018,382,124,506
2314,30780,Bus,2002,214,107,321
2315,30780,Bus,2003,232,48,280
2316,30780,Bus,2004,241,43,284
2317,30780,Bus,2005,243,45,288
2318,30780,Bus,2006,234,55,289
2319,30780,Bus,2007,160,128,288
2320,30780,Bus,2012,139,149,288
2321,30780,Bus,2013,134,144,278
2322,30780,Bus,2014,167,187,354
2323,30780,Bus,2015,126,209,335
2324,30780,Bus,2016,95,179,274
2325,30780,Bus,2017,99,161,260
2326,30780,Bus,2018,125,409,534
2327,30780,Rail,2002,0,0,0
2328,30780,Rail,2003,0,0,0
2329,30780,Rail,2004,0,3,3
2330,30780,Rail,2005,6,3,9
2331,30780,Rail,2006,8,12,20
2332,30780,Rail,2007,9,13,22
2333,30780,Rail,2012,2,7,9
2334,30780,Rail,2013,2,10,12
2335,30780,Rail,2014,3,12,15
2336,30780,Rail,2015,5,16,21
2337,30780,Rail,2016,5,12,17
2338,30780,Rail,2017,8,19,27
2339,30780,Rail,2018,6,14,20
2340,30860,Bus,2002,0,0,0
2341,30860,Bus,2003,0,0,0
2342,30860,Bus,2004,0,0,0
2343,30860,Bus,2005,0,0,0
2344,30860,Bus,2006,0,0,0
2345,30860,Bus,2007,0,0,0
2346,30860,Bus,2012,54,70,124
2347,30860,Bus,2013,40,61,101
2348,30860,Bus,2014,38,82,120
2349,30860,Bus,2015,64,58,122
2350,30860,Bus,2016,62,106,168
2351,30860,Bus,2017,46,115,161
2352,30860,Bus,2018,57,108,165
2353,31020,Bus,2002,9,20,29
2354,31020,Bus,2003,12,30,42
2355,31020,Bus,2004,17,6,23
2356,31020,Bus,2005,8,12,20
2357,31020,Bus,2006,15,4,19
2358,31020,Bus,2007,13,3,16
2359,31020,Bus,2012,23,21,44
2360,31020,Bus,2013,18,16,34
2361,31020,Bus,2014,22,17,39
2362,31020,Bus,2015,28,4,32
2363,31020,Bus,2016,56,6,62
2364,31020,Bus,2017,42,10,52
2365,31020,Bus,2018,27,12,39
2366,31100,Bus,2002,25998,4388,30386
2367,31100,Bus,2003,21135,4502,25637
2368,31100,Bus,2004,18692,6690,25382
2369,31100,Bus,2005,28440,7196,35636
2370,31100,Bus,2006,18826,23383,42209
2371,31100,Bus,2007,18760,23383,42143
2372,31100,Bus,2012,15575,22178,37753
2373,31100,Bus,2013,15008,21654,36662
2374,31100,Bus,2014,14924,19834,34758
2375,31100,Bus,2015,14446,17468,31914
2376,31100,Bus,2016,13295,17211,30506
2377,31100,Bus,2017,12212,16071,28283
2378,31100,Bus,2018,13443,16928,30371
2379,31100,Rail,2002,1941,1925,3866
2380,31100,Rail,2003,1893,1759,3652
2381,31100,Rail,2004,867,948,1815
2382,31100,Rail,2005,1084,3318,4402
2383,31100,Rail,2006,667,3586,4253
2384,31100,Rail,2007,678,4135,4813
2385,31100,Rail,2012,742,201,943
2386,31100,Rail,2013,797,133,930
2387,31100,Rail,2014,736,165,901
2388,31100,Rail,2015,623,128,751
2389,31100,Rail,2016,658,133,791
2390,31100,Rail,2017,786,79,865
2391,31100,Rail,2018,802,89,891
2392,31140,Bus,2002,1355,1324,2679
2393,31140,Bus,2003,1565,1455,3020
2394,31140,Bus,2004,1349,1442,2791
2395,31140,Bus,2005,1463,1584,3047
2396,31140,Bus,2006,1993,459,2452
2397,31140,Bus,2007,1505,1030,2535
2398,31140,Bus,2012,1235,1944,3179
2399,31140,Bus,2013,1280,2185,3465
2400,31140,Bus,2014,1130,2395,3525
2401,31140,Bus,2015,1002,2270,3272
2402,31140,Bus,2016,1267,2415,3682
2403,31140,Bus,2017,1182,2333,3515
2404,31140,Bus,2018,1329,2415,3744
2405,31180,Bus,2002,96,0,96
2406,31180,Bus,2003,19,11,30
2407,31180,Bus,2004,69,62,131
2408,31180,Bus,2005,52,62,114
2409,31180,Bus,2006,71,73,144
2410,31180,Bus,2007,45,50,95
2411,31180,Bus,2012,220,128,348
2412,31180,Bus,2013,236,132,368
2413,31180,Bus,2014,283,159,442
2414,31180,Bus,2015,198,114,312
2415,31180,Bus,2016,238,136,374
2416,31180,Bus,2017,190,71,261
2417,31180,Bus,2018,51,150,201
2418,31340,Bus,2002,201,159,360
2419,31340,Bus,2003,297,235,532
2420,31340,Bus,2004,292,231,523
2421,31340,Bus,2005,319,205,524
2422,31340,Bus,2006,424,238,662
2423,31340,Bus,2007,983,810,1793
2424,31340,Bus,2012,1,11,12
2425,31340,Bus,2013,2,10,12
2426,31340,Bus,2014,5,45,50
2427,31340,Bus,2015,6,42,48
2428,31340,Bus,2016,12,31,43
2429,31340,Bus,2017,23,7,30
2430,31340,Bus,2018,33,4,37
2431,31540,Bus,2002,405,235,640
2432,31540,Bus,2003,354,234,588
2433,31540,Bus,2004,489,202,691
2434,31540,Bus,2005,388,371,759
2435,31540,Bus,2006,324,439,763
2436,31540,Bus,2007,404,508,912
2437,31540,Bus,2012,545,639,1184
2438,31540,Bus,2013,449,873,1322
2439,31540,Bus,2014,449,873,1322
2440,31540,Bus,2015,619,447,1066
2441,31540,Bus,2016,414,266,680
2442,31540,Bus,2017,303,230,533
2443,31540,Bus,2018,341,235,576
2444,31700,Bus,2002,23,4,27
2445,31700,Bus,2003,28,12,40
2446,31700,Bus,2004,35,4,39
2447,31700,Bus,2005,30,19,49
2448,31700,Bus,2006,30,10,40
2449,31700,Bus,2007,39,18,57
2450,31700,Bus,2012,38,7,45
2451,31700,Bus,2013,32,24,56
2452,31700,Bus,2014,54,34,88
2453,31700,Bus,2015,52,27,79
2454,31700,Bus,2016,50,26,76
2455,31700,Bus,2017,54,31,85
2456,31700,Bus,2018,42,22,64
2457,31900,Bus,2002,0,0,0
2458,31900,Bus,2003,0,0,0
2459,31900,Bus,2004,0,0,0
2460,31900,Bus,2005,0,0,0
2461,31900,Bus,2006,0,0,0
2462,31900,Bus,2007,0,0,0
2463,31900,Bus,2012,0,0,0
2464,31900,Bus,2013,0,0,0
2465,31900,Bus,2014,0,0,0
2466,31900,Bus,2015,0,0,0
2467,31900,Bus,2016,0,0,0
2468,31900,Bus,2017,0,0,0
2469,31900,Bus,2018,0,0,0
2470,32580,Bus,2002,0,0,0
2471,32580,Bus,2003,0,30,30
2472,32580,Bus,2004,0,28,28
2473,32580,Bus,2005,0,28,28
2474,32580,Bus,2006,20,7,27
2475,32580,Bus,2007,19,3,22
2476,32580,Bus,2012,0,0,0
2477,32580,Bus,2013,0,0,0
2478,32580,Bus,2014,0,0,0
2479,32580,Bus,2015,17,127,144
2480,32580,Bus,2016,22,94,116
2481,32580,Bus,2017,58,136,194
2482,32580,Bus,2018,23,86,109
2483,32780,Bus,2002,0,2,2
2484,32780,Bus,2003,0,7,7
2485,32780,Bus,2004,0,0,0
2486,32780,Bus,2005,1,3,4
2487,32780,Bus,2006,3,3,6
2488,32780,Bus,2007,6,3,9
2489,32780,Bus,2012,62,64,126
2490,32780,Bus,2013,45,113,158
2491,32780,Bus,2014,70,84,154
2492,32780,Bus,2015,60,171,231
2493,32780,Bus,2016,41,60,101
2494,32780,Bus,2017,84,79,163
2495,32780,Bus,2018,84,54,138
2496,32820,Bus,2002,2614,1385,3999
2497,32820,Bus,2003,1679,2112,3791
2498,32820,Bus,2004,1442,2501,3943
2499,32820,Bus,2005,1337,2487,3824
2500,32820,Bus,2006,1434,2476,3910
2501,32820,Bus,2007,1505,3103,4608
2502,32820,Bus,2012,432,2777,3209
2503,32820,Bus,2013,436,2395,2831
2504,32820,Bus,2014,382,1903,2285
2505,32820,Bus,2015,181,1479,1660
2506,32820,Bus,2016,196,1523,1719
2507,32820,Bus,2017,219,1707,1926
2508,32820,Bus,2018,215,1604,1819
2509,32820,Rail,2002,23,103,126
2510,32820,Rail,2003,48,300,348
2511,32820,Rail,2004,48,300,348
2512,32820,Rail,2005,27,483,510
2513,32820,Rail,2006,55,237,292
2514,32820,Rail,2007,64,283,347
2515,32820,Rail,2012,84,793,877
2516,32820,Rail,2013,92,797,889
2517,32820,Rail,2014,89,540,629
2518,32820,Rail,2015,0,0,0
2519,32820,Rail,2016,0,0,0
2520,32820,Rail,2017,0,0,0
2521,32820,Rail,2018,0,70,70
2522,32900,Bus,2002,98,81,179
2523,32900,Bus,2003,85,37,122
2524,32900,Bus,2004,51,32,83
2525,32900,Bus,2005,131,143,274
2526,32900,Bus,2006,108,144,252
2527,32900,Bus,2007,0,0,0
2528,32900,Bus,2012,6,38,44
2529,32900,Bus,2013,37,113,150
2530,32900,Bus,2014,26,91,117
2531,32900,Bus,2015,26,64,90
2532,32900,Bus,2016,39,39,78
2533,32900,Bus,2017,53,34,87
2534,32900,Bus,2018,31,72,103
2535,33100,Bus,2002,13399,4369,17768
2536,33100,Bus,2003,8069,4876,12945
2537,33100,Bus,2004,8291,5969,14260
2538,33100,Bus,2005,9974,7503,17477
2539,33100,Bus,2006,11724,9096,20820
2540,33100,Bus,2007,9847,6479,16326
2541,33100,Bus,2012,7911,7344,15255
2542,33100,Bus,2013,8620,10358,18978
2543,33100,Bus,2014,11858,10801,22659
2544,33100,Bus,2015,13251,10702,23953
2545,33100,Bus,2016,13374,9762,23136
2546,33100,Bus,2017,7090,12501,19591
2547,33100,Bus,2018,8321,12405,20726
2548,33100,Rail,2002,2219,378,2597
2549,33100,Rail,2003,1908,388,2296
2550,33100,Rail,2004,1933,250,2183
2551,33100,Rail,2005,1677,625,2302
2552,33100,Rail,2006,1836,905,2741
2553,33100,Rail,2007,1705,774,2479
2554,33100,Rail,2012,467,2974,3441
2555,33100,Rail,2013,432,2655,3087
2556,33100,Rail,2014,476,2697,3173
2557,33100,Rail,2015,480,2678,3158
2558,33100,Rail,2016,297,2480,2777
2559,33100,Rail,2017,488,2297,2785
2560,33100,Rail,2018,561,1941,2502
2561,33340,Bus,2002,3089,4368,7457
2562,33340,Bus,2003,2821,3948,6769
2563,33340,Bus,2004,2706,3620,6326
2564,33340,Bus,2005,2815,3386,6201
2565,33340,Bus,2006,2798,3276,6074
2566,33340,Bus,2007,3282,3555,6837
2567,33340,Bus,2012,2712,3499,6211
2568,33340,Bus,2013,3900,3865,7765
2569,33340,Bus,2014,666,401,1067
2570,33340,Bus,2015,722,659,1381
2571,33340,Bus,2016,460,486,946
2572,33340,Bus,2017,988,705,1693
2573,33340,Bus,2018,3204,2843,6047
2574,33460,Bus,2002,2149,16557,18706
2575,33460,Bus,2003,5778,4838,10616
2576,33460,Bus,2004,1459,7699,9158
2577,33460,Bus,2005,533,8758,9291
2578,33460,Bus,2006,800,8862,9662
2579,33460,Bus,2007,1079,9547,10626
2580,33460,Bus,2012,648,7749,8397
2581,33460,Bus,2013,760,8315,9075
2582,33460,Bus,2014,896,8124,9020
2583,33460,Bus,2015,946,7978,8924
2584,33460,Bus,2016,1063,6603,7666
2585,33460,Bus,2017,1178,6283,7461
2586,33460,Bus,2018,1140,6517,7657
2587,33460,Rail,2002,0,0,0
2588,33460,Rail,2003,0,0,0
2589,33460,Rail,2004,36,1,37
2590,33460,Rail,2005,0,57,57
2591,33460,Rail,2006,4,26,30
2592,33460,Rail,2007,3,42,45
2593,33460,Rail,2012,67,119,186
2594,33460,Rail,2013,81,58,139
2595,33460,Rail,2014,140,211,351
2596,33460,Rail,2015,179,169,348
2597,33460,Rail,2016,184,110,294
2598,33460,Rail,2017,103,132,235
2599,33460,Rail,2018,113,312,425
2600,33540,Bus,2002,16,25,41
2601,33540,Bus,2003,28,28,56
2602,33540,Bus,2004,28,18,46
2603,33540,Bus,2005,20,7,27
2604,33540,Bus,2006,31,10,41
2605,33540,Bus,2007,31,17,48
2606,33540,Bus,2012,51,70,121
2607,33540,Bus,2013,41,49,90
2608,33540,Bus,2014,20,19,39
2609,33540,Bus,2015,30,20,50
2610,33540,Bus,2016,25,16,41
2611,33540,Bus,2017,34,60,94
2612,33540,Bus,2018,68,89,157
2613,33660,Bus,2002,0,0,0
2614,33660,Bus,2003,359,145,504
2615,33660,Bus,2004,360,108,468
2616,33660,Bus,2005,199,89,288
2617,33660,Bus,2006,163,98,261
2618,33660,Bus,2007,183,107,290
2619,33660,Bus,2012,39,40,79
2620,33660,Bus,2013,52,92,144
2621,33660,Bus,2014,74,149,223
2622,33660,Bus,2015,119,166,285
2623,33660,Bus,2016,101,163,264
2624,33660,Bus,2017,45,124,169
2625,33660,Bus,2018,45,153,198
2626,33700,Bus,2002,98,81,179
2627,33700,Bus,2003,85,37,122
2628,33700,Bus,2004,51,32,83
2629,33700,Bus,2005,131,143,274
2630,33700,Bus,2006,108,144,252
2631,33700,Bus,2007,0,0,0
2632,33700,Bus,2012,107,49,156
2633,33700,Bus,2013,93,28,121
2634,33700,Bus,2014,50,23,73
2635,33700,Bus,2015,63,12,75
2636,33700,Bus,2016,37,20,57
2637,33700,Bus,2017,61,13,74
2638,33700,Bus,2018,35,35,70
2639,33740,Bus,2002,42,62,104
2640,33740,Bus,2003,5,3,8
2641,33740,Bus,2004,30,50,80
2642,33740,Bus,2005,35,45,80
2643,33740,Bus,2006,30,51,81
2644,33740,Bus,2007,37,68,105
2645,33740,Bus,2012,0,0,0
2646,33740,Bus,2013,0,0,0
2647,33740,Bus,2014,0,0,0
2648,33740,Bus,2015,0,0,0
2649,33740,Bus,2016,0,0,0
2650,33740,Bus,2017,0,0,0
2651,33740,Bus,2018,0,0,0
2652,33860,Bus,2002,97,6,103
2653,33860,Bus,2003,0,67,67
2654,33860,Bus,2004,77,0,77
2655,33860,Bus,2005,104,0,104
2656,33860,Bus,2006,80,0,80
2657,33860,Bus,2007,107,0,107
2658,33860,Bus,2012,95,23,118
2659,33860,Bus,2013,90,13,103
2660,33860,Bus,2014,124,24,148
2661,33860,Bus,2015,60,14,74
2662,33860,Bus,2016,55,22,77
2663,33860,Bus,2017,65,34,99
2664,33860,Bus,2018,55,27,82
2665,34060,Bus,2002,0,0,0
2666,34060,Bus,2003,0,0,0
2667,34060,Bus,2004,0,0,0
2668,34060,Bus,2005,46,3,49
2669,34060,Bus,2006,64,8,72
2670,34060,Bus,2007,89,27,116
2671,34060,Bus,2012,0,0,0
2672,34060,Bus,2013,0,0,0
2673,34060,Bus,2014,0,0,0
2674,34060,Bus,2015,0,0,0
2675,34060,Bus,2016,0,0,0
2676,34060,Bus,2017,0,0,0
2677,34060,Bus,2018,0,0,0
2678,34060,Rail,2002,0,0,0
2679,34060,Rail,2003,0,0,0
2680,34060,Rail,2004,0,0,0
2681,34060,Rail,2005,0,0,0
2682,34060,Rail,2006,0,0,0
2683,34060,Rail,2007,0,0,0
2684,34060,Rail,2012,234,225,459
2685,34060,Rail,2013,251,181,432
2686,34060,Rail,2014,246,189,435
2687,34060,Rail,2015,245,184,429
2688,34060,Rail,2016,288,224,512
2689,34060,Rail,2017,301,237,538
2690,34060,Rail,2018,189,261,450
2691,34580,Bus,2002,0,0,0
2692,34580,Bus,2003,0,0,0
2693,34580,Bus,2004,21,6,27
2694,34580,Bus,2005,25,9,34
2695,34580,Bus,2006,41,167,208
2696,34580,Bus,2007,30,9,39
2697,34580,Bus,2012,23,11,34
2698,34580,Bus,2013,17,1,18
2699,34580,Bus,2014,21,4,25
2700,34580,Bus,2015,16,10,26
2701,34580,Bus,2016,17,4,21
2702,34580,Bus,2017,35,7,42
2703,34580,Bus,2018,22,17,39
2704,34620,Bus,2002,39,100,139
2705,34620,Bus,2003,28,90,118
2706,34620,Bus,2004,30,104,134
2707,34620,Bus,2005,30,117,147
2708,34620,Bus,2006,16,81,97
2709,34620,Bus,2007,10,46,56
2710,34620,Bus,2012,6,28,34
2711,34620,Bus,2013,8,19,27
2712,34620,Bus,2014,1,0,1
2713,34620,Bus,2015,0,26,26
2714,34620,Bus,2016,0,32,32
2715,34620,Bus,2017,0,24,24
2716,34620,Bus,2018,0,37,37
2717,34740,Bus,2002,41,11,52
2718,34740,Bus,2003,71,20,91
2719,34740,Bus,2004,78,19,97
2720,34740,Bus,2005,62,27,89
2721,34740,Bus,2006,85,24,109
2722,34740,Bus,2007,48,37,85
2723,34740,Bus,2012,0,0,0
2724,34740,Bus,2013,0,0,0
2725,34740,Bus,2014,0,0,0
2726,34740,Bus,2015,0,0,0
2727,34740,Bus,2016,0,0,0
2728,34740,Bus,2017,0,0,0
2729,34740,Bus,2018,0,0,0
2730,34820,Bus,2002,4,77,81
2731,34820,Bus,2003,14,6,20
2732,34820,Bus,2004,41,0,41
2733,34820,Bus,2005,45,0,45
2734,34820,Bus,2006,50,0,50
2735,34820,Bus,2007,43,0,43
2736,34820,Bus,2012,40,151,191
2737,34820,Bus,2013,27,144,171
2738,34820,Bus,2014,29,213,242
2739,34820,Bus,2015,141,95,236
2740,34820,Bus,2016,0,0,0
2741,34820,Bus,2017,0,0,0
2742,34820,Bus,2018,0,0,0
2743,34900,Bus,2002,0,0,0
2744,34900,Bus,2003,0,0,0
2745,34900,Bus,2004,0,0,0
2746,34900,Bus,2005,0,0,0
2747,34900,Bus,2006,0,0,0
2748,34900,Bus,2007,0,0,0
2749,34900,Bus,2012,41,31,72
2750,34900,Bus,2013,153,155,308
2751,34900,Bus,2014,234,196,430
2752,34900,Bus,2015,210,90,300
2753,34900,Bus,2016,222,79,301
2754,34900,Bus,2017,264,105,369
2755,34900,Bus,2018,205,77,282
2756,34940,Bus,2002,0,0,0
2757,34940,Bus,2003,0,0,0
2758,34940,Bus,2004,0,0,0
2759,34940,Bus,2005,0,0,0
2760,34940,Bus,2006,0,0,0
2761,34940,Bus,2007,0,0,0
2762,34940,Bus,2012,68,9,77
2763,34940,Bus,2013,52,2,54
2764,34940,Bus,2014,28,1,29
2765,34940,Bus,2015,31,0,31
2766,34940,Bus,2016,23,0,23
2767,34940,Bus,2017,94,27,121
2768,34940,Bus,2018,98,54,152
2769,34980,Bus,2002,240,860,1100
2770,34980,Bus,2003,292,1034,1326
2771,34980,Bus,2004,297,1234,1531
2772,34980,Bus,2005,110,875,985
2773,34980,Bus,2006,640,497,1137
2774,34980,Bus,2007,773,499,1272
2775,34980,Bus,2012,668,434,1102
2776,34980,Bus,2013,742,298,1040
2777,34980,Bus,2014,882,279,1161
2778,34980,Bus,2015,616,277,893
2779,34980,Bus,2016,920,377,1297
2780,34980,Bus,2017,1040,151,1191
2781,34980,Bus,2018,2365,916,3281
2782,34980,Rail,2002,0,0,0
2783,34980,Rail,2003,0,0,0
2784,34980,Rail,2004,0,0,0
2785,34980,Rail,2005,0,0,0
2786,34980,Rail,2006,0,0,0
2787,34980,Rail,2007,0,0,0
2788,34980,Rail,2012,5,4,9
2789,34980,Rail,2013,5,2,7
2790,34980,Rail,2014,3,0,3
2791,34980,Rail,2015,0,0,0
2792,34980,Rail,2016,3,0,3
2793,34980,Rail,2017,3,5,8
2794,34980,Rail,2018,4,0,4
2795,35300,Bus,2002,1863,1495,3358
2796,35300,Bus,2003,2127,1635,3762
2797,35300,Bus,2004,2135,1557,3692
2798,35300,Bus,2005,1902,2146,4048
2799,35300,Bus,2006,1872,2211,4083
2800,35300,Bus,2007,1944,2229,4173
2801,35300,Bus,2012,2246,3229,5475
2802,35300,Bus,2013,1521,3167,4688
2803,35300,Bus,2014,1150,3545,4695
2804,35300,Bus,2015,1121,3246,4367
2805,35300,Bus,2016,1170,2785,3955
2806,35300,Bus,2017,987,2511,3498
2807,35300,Bus,2018,602,2538,3140
2808,35380,Bus,2002,2498,4413,6911
2809,35380,Bus,2003,1971,3627,5598
2810,35380,Bus,2004,2127,3079,5206
2811,35380,Bus,2005,0,0,0
2812,35380,Bus,2006,2330,1679,4009
2813,35380,Bus,2007,1231,496,1727
2814,35380,Bus,2012,272,564,836
2815,35380,Bus,2013,445,697,1142
2816,35380,Bus,2014,491,917,1408
2817,35380,Bus,2015,705,840,1545
2818,35380,Bus,2016,694,918,1612
2819,35380,Bus,2017,616,943,1559
2820,35380,Bus,2018,733,1018,1751
2821,35380,Rail,2002,96,44,140
2822,35380,Rail,2003,71,62,133
2823,35380,Rail,2004,137,62,199
2824,35380,Rail,2005,0,0,0
2825,35380,Rail,2006,105,26,131
2826,35380,Rail,2007,56,15,71
2827,35380,Rail,2012,74,54,128
2828,35380,Rail,2013,91,61,152
2829,35380,Rail,2014,97,70,167
2830,35380,Rail,2015,46,58,104
2831,35380,Rail,2016,75,87,162
2832,35380,Rail,2017,33,114,147
2833,35380,Rail,2018,37,129,166
2834,35620,Bus,2002,29724,19167,48891
2835,35620,Bus,2003,32830,13121,45951
2836,35620,Bus,2004,33971,12868,46839
2837,35620,Bus,2005,37859,11796,49655
2838,35620,Bus,2006,46706,13344,60050
2839,35620,Bus,2007,39343,16213,55556
2840,35620,Bus,2012,35069,16552,51621
2841,35620,Bus,2013,32783,16106,48889
2842,35620,Bus,2014,37931,17012,54943
2843,35620,Bus,2015,33124,17430,50554
2844,35620,Bus,2016,27862,17097,44959
2845,35620,Bus,2017,27270,16078,43348
2846,35620,Bus,2018,26389,14212,40601
2847,35620,Rail,2002,4740,7923,12663
2848,35620,Rail,2003,3486,6065,9551
2849,35620,Rail,2004,3318,6412,9730
2850,35620,Rail,2005,2951,6486,9437
2851,35620,Rail,2006,2976,7828,10804
2852,35620,Rail,2007,3099,8419,11518
2853,35620,Rail,2012,2688,8112,10800
2854,35620,Rail,2013,2912,8648,11560
2855,35620,Rail,2014,3223,10546,13769
2856,35620,Rail,2015,3351,10476,13827
2857,35620,Rail,2016,3865,10302,14167
2858,35620,Rail,2017,3736,11054,14790
2859,35620,Rail,2018,3928,12746,16674
2860,35660,Bus,2002,108,57,165
2861,35660,Bus,2003,40,26,66
2862,35660,Bus,2004,39,7,46
2863,35660,Bus,2005,113,23,136
2864,35660,Bus,2006,51,16,67
2865,35660,Bus,2007,85,24,109
2866,35660,Bus,2012,139,8,147
2867,35660,Bus,2013,144,9,153
2868,35660,Bus,2014,113,9,122
2869,35660,Bus,2015,137,13,150
2870,35660,Bus,2016,127,26,153
2871,35660,Bus,2017,77,21,98
2872,35660,Bus,2018,86,111,197
2873,35840,Bus,2002,48,756,804
2874,35840,Bus,2003,68,659,727
2875,35840,Bus,2004,25,484,509
2876,35840,Bus,2005,11,390,401
2877,35840,Bus,2006,15,266,281
2878,35840,Bus,2007,33,212,245
2879,35840,Bus,2012,339,445,784
2880,35840,Bus,2013,466,432,898
2881,35840,Bus,2014,559,362,921
2882,35840,Bus,2015,620,534,1154
2883,35840,Bus,2016,612,444,1056
2884,35840,Bus,2017,657,337,994
2885,35840,Bus,2018,696,322,1018
2886,35980,Bus,2002,27,182,209
2887,35980,Bus,2003,38,149,187
2888,35980,Bus,2004,26,126,152
2889,35980,Bus,2005,22,127,149
2890,35980,Bus,2006,19,137,156
2891,35980,Bus,2007,23,118,141
2892,35980,Bus,2012,180,33,213
2893,35980,Bus,2013,338,50,388
2894,35980,Bus,2014,40,400,440
2895,35980,Bus,2015,122,488,610
2896,35980,Bus,2016,120,480,600
2897,35980,Bus,2017,156,625,781
2898,35980,Bus,2018,333,607,940
2899,36100,Bus,2002,0,0,0
2900,36100,Bus,2003,0,0,0
2901,36100,Bus,2004,0,0,0
2902,36100,Bus,2005,0,0,0
2903,36100,Bus,2006,0,0,0
2904,36100,Bus,2007,0,0,0
2905,36100,Bus,2012,32,42,74
2906,36100,Bus,2013,47,27,74
2907,36100,Bus,2014,67,38,105
2908,36100,Bus,2015,42,51,93
2909,36100,Bus,2016,64,28,92
2910,36100,Bus,2017,11,90,101
2911,36100,Bus,2018,5,93,98
2912,36140,Bus,2002,0,0,0
2913,36140,Bus,2003,0,0,0
2914,36140,Bus,2004,0,0,0
2915,36140,Bus,2005,0,0,0
2916,36140,Bus,2006,0,0,0
2917,36140,Bus,2007,0,0,0
2918,36140,Bus,2012,0,0,0
2919,36140,Bus,2013,0,0,0
2920,36140,Bus,2014,3,2,5
2921,36140,Bus,2015,0,0,0
2922,36140,Bus,2016,0,0,0
2923,36140,Bus,2017,0,0,0
2924,36140,Bus,2018,0,0,0
2925,36220,Bus,2002,0,0,0
2926,36220,Bus,2003,0,0,0
2927,36220,Bus,2004,20,5,25
2928,36220,Bus,2005,30,14,44
2929,36220,Bus,2006,51,66,117
2930,36220,Bus,2007,70,85,155
2931,36220,Bus,2012,9,208,217
2932,36220,Bus,2013,0,0,0
2933,36220,Bus,2014,0,0,0
2934,36220,Bus,2015,0,0,0
2935,36220,Bus,2016,0,0,0
2936,36220,Bus,2017,0,0,0
2937,36220,Bus,2018,0,0,0
2938,36420,Bus,2002,440,252,692
2939,36420,Bus,2003,415,322,737
2940,36420,Bus,2004,357,313,670
2941,36420,Bus,2005,392,711,1103
2942,36420,Bus,2006,486,1111,1597
2943,36420,Bus,2007,589,1844,2433
2944,36420,Bus,2012,206,306,512
2945,36420,Bus,2013,197,210,407
2946,36420,Bus,2014,179,143,322
2947,36420,Bus,2015,171,102,273
2948,36420,Bus,2016,156,47,203
2949,36420,Bus,2017,137,103,240
2950,36420,Bus,2018,102,90,192
2951,36500,Bus,2002,210,257,467
2952,36500,Bus,2003,253,216,469
2953,36500,Bus,2004,226,385,611
2954,36500,Bus,2005,268,404,672
2955,36500,Bus,2006,246,373,619
2956,36500,Bus,2007,229,298,527
2957,36500,Bus,2012,231,367,598
2958,36500,Bus,2013,193,228,421
2959,36500,Bus,2014,108,148,256
2960,36500,Bus,2015,103,30,133
2961,36500,Bus,2016,123,28,151
2962,36500,Bus,2017,91,74,165
2963,36500,Bus,2018,54,66,120
2964,36540,Bus,2002,3,272,275
2965,36540,Bus,2003,5,441,446
2966,36540,Bus,2004,421,12,433
2967,36540,Bus,2005,487,57,544
2968,36540,Bus,2006,501,49,550
2969,36540,Bus,2007,417,174,591
2970,36540,Bus,2012,277,646,923
2971,36540,Bus,2013,228,681,909
2972,36540,Bus,2014,524,2076,2600
2973,36540,Bus,2015,311,2601,2912
2974,36540,Bus,2016,224,2494,2718
2975,36540,Bus,2017,218,3127,3345
2976,36540,Bus,2018,141,2477,2618
2977,36740,Bus,2002,236,640,876
2978,36740,Bus,2003,201,621,822
2979,36740,Bus,2004,119,952,1071
2980,36740,Bus,2005,87,1189,1276
2981,36740,Bus,2006,904,415,1319
2982,36740,Bus,2007,322,1428,1750
2983,36740,Bus,2012,1021,34,1055
2984,36740,Bus,2013,1600,482,2082
2985,36740,Bus,2014,1689,437,2126
2986,36740,Bus,2015,1078,267,1345
2987,36740,Bus,2016,1298,229,1527
2988,36740,Bus,2017,997,248,1245
2989,36740,Bus,2018,896,369,1265
2990,36740,Rail,2002,0,0,0
2991,36740,Rail,2003,0,0,0
2992,36740,Rail,2004,0,0,0
2993,36740,Rail,2005,0,0,0
2994,36740,Rail,2006,0,0,0
2995,36740,Rail,2007,0,0,0
2996,36740,Rail,2012,0,0,0
2997,36740,Rail,2013,0,0,0
2998,36740,Rail,2014,0,0,0
2999,36740,Rail,2015,0,2,2
3000,36740,Rail,2016,0,3,3
3001,36740,Rail,2017,0,6,6
3002,36740,Rail,2018,0,8,8
3003,36780,Bus,2002,10,27,37
3004,36780,Bus,2003,35,107,142
3005,36780,Bus,2004,38,130,168
3006,36780,Bus,2005,38,102,140
3007,36780,Bus,2006,47,100,147
3008,36780,Bus,2007,53,126,179
3009,36780,Bus,2012,63,178,241
3010,36780,Bus,2013,55,274,329
3011,36780,Bus,2014,97,231,328
3012,36780,Bus,2015,96,155,251
3013,36780,Bus,2016,96,200,296
3014,36780,Bus,2017,116,195,311
3015,36780,Bus,2018,73,203,276
3016,37100,Bus,2002,251,134,385
3017,37100,Bus,2003,246,132,378
3018,37100,Bus,2004,240,112,352
3019,37100,Bus,2005,300,98,398
3020,37100,Bus,2006,228,141,369
3021,37100,Bus,2007,310,156,466
3022,37100,Bus,2012,110,21,131
3023,37100,Bus,2013,111,30,141
3024,37100,Bus,2014,177,20,197
3025,37100,Bus,2015,169,27,196
3026,37100,Bus,2016,175,34,209
3027,37100,Bus,2017,159,23,182
3028,37100,Bus,2018,199,33,232
3029,37340,Bus,2002,7,29,36
3030,37340,Bus,2003,14,25,39
3031,37340,Bus,2004,10,7,17
3032,37340,Bus,2005,20,25,45
3033,37340,Bus,2006,16,27,43
3034,37340,Bus,2007,41,21,62
3035,37340,Bus,2012,16,83,99
3036,37340,Bus,2013,20,27,47
3037,37340,Bus,2014,20,27,47
3038,37340,Bus,2015,19,26,45
3039,37340,Bus,2016,17,23,40
3040,37340,Bus,2017,18,25,43
3041,37340,Bus,2018,21,29,50
3042,37380,Bus,2002,15,2,17
3043,37380,Bus,2003,26,3,29
3044,37380,Bus,2004,173,122,295
3045,37380,Bus,2005,271,77,348
3046,37380,Bus,2006,427,116,543
3047,37380,Bus,2007,417,245,662
3048,37380,Bus,2012,383,126,509
3049,37380,Bus,2013,469,93,562
3050,37380,Bus,2014,179,400,579
3051,37380,Bus,2015,175,428,603
3052,37380,Bus,2016,302,181,483
3053,37380,Bus,2017,329,90,419
3054,37380,Bus,2018,398,130,528
3055,37460,Bus,2002,41,11,52
3056,37460,Bus,2003,71,20,91
3057,37460,Bus,2004,78,19,97
3058,37460,Bus,2005,62,27,89
3059,37460,Bus,2006,85,24,109
3060,37460,Bus,2007,48,37,85
3061,37460,Bus,2012,30,51,81
3062,37460,Bus,2013,28,44,72
3063,37460,Bus,2014,46,21,67
3064,37460,Bus,2015,21,9,30
3065,37460,Bus,2016,6,5,11
3066,37460,Bus,2017,5,5,10
3067,37460,Bus,2018,0,0,0
3068,37620,Bus,2002,1,4,5
3069,37620,Bus,2003,2,10,12
3070,37620,Bus,2004,0,0,0
3071,37620,Bus,2005,0,0,0
3072,37620,Bus,2006,0,0,0
3073,37620,Bus,2007,0,0,0
3074,37620,Bus,2012,0,0,0
3075,37620,Bus,2013,0,0,0
3076,37620,Bus,2014,0,0,0
3077,37620,Bus,2015,0,0,0
3078,37620,Bus,2016,0,0,0
3079,37620,Bus,2017,0,0,0
3080,37620,Bus,2018,0,0,0
3081,37700,Bus,2002,101,80,181
3082,37700,Bus,2003,156,191,347
3083,37700,Bus,2004,128,145,273
3084,37700,Bus,2005,120,199,319
3085,37700,Bus,2006,104,77,181
3086,37700,Bus,2007,96,84,180
3087,37700,Bus,2012,142,398,540
3088,37700,Bus,2013,230,458,688
3089,37700,Bus,2014,241,374,615
3090,37700,Bus,2015,225,356,581
3091,37700,Bus,2016,211,137,348
3092,37700,Bus,2017,151,210,361
3093,37700,Bus,2018,128,242,370
3094,37860,Bus,2002,45,4,49
3095,37860,Bus,2003,77,14,91
3096,37860,Bus,2004,86,0,86
3097,37860,Bus,2005,125,0,125
3098,37860,Bus,2006,191,12,203
3099,37860,Bus,2007,196,38,234
3100,37860,Bus,2012,112,38,150
3101,37860,Bus,2013,42,79,121
3102,37860,Bus,2014,48,110,158
3103,37860,Bus,2015,72,47,119
3104,37860,Bus,2016,95,18,113
3105,37860,Bus,2017,97,23,120
3106,37860,Bus,2018,58,129,187
3107,37900,Bus,2002,126,434,560
3108,37900,Bus,2003,174,325,499
3109,37900,Bus,2004,112,311,423
3110,37900,Bus,2005,136,332,468
3111,37900,Bus,2006,132,546,678
3112,37900,Bus,2007,294,482,776
3113,37900,Bus,2012,256,300,556
3114,37900,Bus,2013,187,324,511
3115,37900,Bus,2014,311,230,541
3116,37900,Bus,2015,497,261,758
3117,37900,Bus,2016,612,305,917
3118,37900,Bus,2017,548,237,785
3119,37900,Bus,2018,546,292,838
3120,37980,Bus,2002,4608,2505,7113
3121,37980,Bus,2003,4496,2571,7067
3122,37980,Bus,2004,7767,3587,11354
3123,37980,Bus,2005,6683,2999,9682
3124,37980,Bus,2006,7897,3696,11593
3125,37980,Bus,2007,7482,3702,11184
3126,37980,Bus,2012,7185,2928,10113
3127,37980,Bus,2013,7289,2817,10106
3128,37980,Bus,2014,8231,3847,12078
3129,37980,Bus,2015,7215,3533,10748
3130,37980,Bus,2016,5985,2803,8788
3131,37980,Bus,2017,6421,3221,9642
3132,37980,Bus,2018,6344,2941,9285
3133,37980,Rail,2002,3263,2084,5347
3134,37980,Rail,2003,953,1232,2185
3135,37980,Rail,2004,779,351,1130
3136,37980,Rail,2005,898,1081,1979
3137,37980,Rail,2006,353,1852,2205
3138,37980,Rail,2007,327,2287,2614
3139,37980,Rail,2012,277,4080,4357
3140,37980,Rail,2013,377,4586,4963
3141,37980,Rail,2014,365,4570,4935
3142,37980,Rail,2015,378,4813,5191
3143,37980,Rail,2016,317,4114,4431
3144,37980,Rail,2017,431,3500,3931
3145,37980,Rail,2018,412,3678,4090
3146,38060,Bus,2002,887,2,889
3147,38060,Bus,2003,2,4,6
3148,38060,Bus,2004,3,2,5
3149,38060,Bus,2005,3,5,8
3150,38060,Bus,2006,5,6,11
3151,38060,Bus,2007,2,12,14
3152,38060,Bus,2012,2464,472,2936
3153,38060,Bus,2013,3879,1020,4899
3154,38060,Bus,2014,4673,2306,6979
3155,38060,Bus,2015,3663,1442,5105
3156,38060,Bus,2016,4310,1339,5649
3157,38060,Bus,2017,5065,2273,7338
3158,38060,Bus,2018,3973,1410,5383
3159,38060,Rail,2002,0,0,0
3160,38060,Rail,2003,0,0,0
3161,38060,Rail,2004,0,0,0
3162,38060,Rail,2005,0,0,0
3163,38060,Rail,2006,0,0,0
3164,38060,Rail,2007,0,0,0
3165,38060,Rail,2012,85,148,233
3166,38060,Rail,2013,82,193,275
3167,38060,Rail,2014,67,188,255
3168,38060,Rail,2015,71,186,257
3169,38060,Rail,2016,75,153,228
3170,38060,Rail,2017,77,217,294
3171,38060,Rail,2018,55,160,215
3172,38300,Bus,2002,10876,27815,38691
3173,38300,Bus,2003,11849,23714,35563
3174,38300,Bus,2004,4590,1652,6242
3175,38300,Bus,2005,6940,1387,8327
3176,38300,Bus,2006,4374,663,5037
3177,38300,Bus,2007,3882,936,4818
3178,38300,Bus,2012,3788,604,4392
3179,38300,Bus,2013,3113,714,3827
3180,38300,Bus,2014,3061,486,3547
3181,38300,Bus,2015,2905,526,3431
3182,38300,Bus,2016,2453,532,2985
3183,38300,Bus,2017,1871,569,2440
3184,38300,Bus,2018,1782,729,2511
3185,38300,Rail,2002,122,65,187
3186,38300,Rail,2003,124,14,138
3187,38300,Rail,2004,350,116,466
3188,38300,Rail,2005,146,108,254
3189,38300,Rail,2006,104,134,238
3190,38300,Rail,2007,105,107,212
3191,38300,Rail,2012,194,281,475
3192,38300,Rail,2013,162,309,471
3193,38300,Rail,2014,172,334,506
3194,38300,Rail,2015,187,162,349
3195,38300,Rail,2016,243,184,427
3196,38300,Rail,2017,220,87,307
3197,38300,Rail,2018,218,102,320
3198,38340,Bus,2002,0,0,0
3199,38340,Bus,2003,0,0,0
3200,38340,Bus,2004,0,0,0
3201,38340,Bus,2005,0,0,0
3202,38340,Bus,2006,0,0,0
3203,38340,Bus,2007,0,0,0
3204,38340,Bus,2012,106,148,254
3205,38340,Bus,2013,74,139,213
3206,38340,Bus,2014,48,105,153
3207,38340,Bus,2015,52,97,149
3208,38340,Bus,2016,79,156,235
3209,38340,Bus,2017,8,31,39
3210,38340,Bus,2018,13,20,33
3211,38540,Bus,2002,18,56,74
3212,38540,Bus,2003,16,57,73
3213,38540,Bus,2004,18,55,73
3214,38540,Bus,2005,16,58,74
3215,38540,Bus,2006,18,54,72
3216,38540,Bus,2007,21,57,78
3217,38540,Bus,2012,0,0,0
3218,38540,Bus,2013,0,0,0
3219,38540,Bus,2014,0,0,0
3220,38540,Bus,2015,0,0,0
3221,38540,Bus,2016,0,0,0
3222,38540,Bus,2017,0,0,0
3223,38540,Bus,2018,0,0,0
3224,38860,Bus,2002,178,538,716
3225,38860,Bus,2003,236,378,614
3226,38860,Bus,2004,349,241,590
3227,38860,Bus,2005,333,192,525
3228,38860,Bus,2006,277,247,524
3229,38860,Bus,2007,250,121,371
3230,38860,Bus,2012,101,323,424
3231,38860,Bus,2013,101,204,305
3232,38860,Bus,2014,101,297,398
3233,38860,Bus,2015,71,322,393
3234,38860,Bus,2016,77,404,481
3235,38860,Bus,2017,54,434,488
3236,38860,Bus,2018,94,453,547
3237,38860,Rail,2002,0,0,0
3238,38860,Rail,2003,0,0,0
3239,38860,Rail,2004,0,0,0
3240,38860,Rail,2005,0,0,0
3241,38860,Rail,2006,0,0,0
3242,38860,Rail,2007,0,0,0
3243,38860,Rail,2012,1,0,1
3244,38860,Rail,2013,0,0,0
3245,38860,Rail,2014,1,0,1
3246,38860,Rail,2015,0,4,4
3247,38860,Rail,2016,0,1,1
3248,38860,Rail,2017,0,2,2
3249,38860,Rail,2018,0,1,1
3250,38900,Bus,2002,2893,1226,4119
3251,38900,Bus,2003,3465,896,4361
3252,38900,Bus,2004,2870,768,3638
3253,38900,Bus,2005,2335,363,2698
3254,38900,Bus,2006,2245,212,2457
3255,38900,Bus,2007,1924,182,2106
3256,38900,Bus,2012,2742,4506,7248
3257,38900,Bus,2013,2351,4308,6659
3258,38900,Bus,2014,1622,4510,6132
3259,38900,Bus,2015,1658,4681,6339
3260,38900,Bus,2016,1382,4536,5918
3261,38900,Bus,2017,1616,6180,7796
3262,38900,Bus,2018,1526,3816,5342
3263,38900,Rail,2002,389,55,444
3264,38900,Rail,2003,310,114,424
3265,38900,Rail,2004,279,113,392
3266,38900,Rail,2005,284,100,384
3267,38900,Rail,2006,189,84,273
3268,38900,Rail,2007,223,76,299
3269,38900,Rail,2012,297,93,390
3270,38900,Rail,2013,258,101,359
3271,38900,Rail,2014,356,56,412
3272,38900,Rail,2015,293,179,472
3273,38900,Rail,2016,379,184,563
3274,38900,Rail,2017,383,226,609
3275,38900,Rail,2018,406,108,514
3276,38940,Bus,2002,0,0,0
3277,38940,Bus,2003,1,0,1
3278,38940,Bus,2004,14,0,14
3279,38940,Bus,2005,14,0,14
3280,38940,Bus,2006,16,4,20
3281,38940,Bus,2007,13,2,15
3282,38940,Bus,2012,35,3,38
3283,38940,Bus,2013,10,0,10
3284,38940,Bus,2014,7,2,9
3285,38940,Bus,2015,5,14,19
3286,38940,Bus,2016,5,11,16
3287,38940,Bus,2017,12,15,27
3288,38940,Bus,2018,22,13,35
3289,39100,Bus,2002,132,188,320
3290,39100,Bus,2003,97,140,237
3291,39100,Bus,2004,84,146,230
3292,39100,Bus,2005,91,187,278
3293,39100,Bus,2006,104,160,264
3294,39100,Bus,2007,105,78,183
3295,39100,Bus,2012,85,121,206
3296,39100,Bus,2013,132,103,235
3297,39100,Bus,2014,114,102,216
3298,39100,Bus,2015,120,97,217
3299,39100,Bus,2016,123,111,234
3300,39100,Bus,2017,111,77,188
3301,39100,Bus,2018,172,83,255
3302,39300,Bus,2002,1741,1927,3668
3303,39300,Bus,2003,1488,1867,3355
3304,39300,Bus,2004,1568,1836,3404
3305,39300,Bus,2005,965,2057,3022
3306,39300,Bus,2006,1096,2034,3130
3307,39300,Bus,2007,1113,1861,2974
3308,39300,Bus,2012,843,1503,2346
3309,39300,Bus,2013,834,1252,2086
3310,39300,Bus,2014,577,1777,2354
3311,39300,Bus,2015,886,1710,2596
3312,39300,Bus,2016,885,2172,3057
3313,39300,Bus,2017,799,2202,3001
3314,39300,Bus,2018,1054,2343,3397
3315,39380,Bus,2002,102,137,239
3316,39380,Bus,2003,103,87,190
3317,39380,Bus,2004,153,111,264
3318,39380,Bus,2005,157,96,253
3319,39380,Bus,2006,130,140,270
3320,39380,Bus,2007,123,153,276
3321,39380,Bus,2012,81,67,148
3322,39380,Bus,2013,98,74,172
3323,39380,Bus,2014,48,99,147
3324,39380,Bus,2015,55,110,165
3325,39380,Bus,2016,52,112,164
3326,39380,Bus,2017,26,20,46
3327,39380,Bus,2018,25,22,47
3328,39540,Bus,2002,67,13,80
3329,39540,Bus,2003,90,51,141
3330,39540,Bus,2004,112,76,188
3331,39540,Bus,2005,84,43,127
3332,39540,Bus,2006,120,64,184
3333,39540,Bus,2007,185,108,293
3334,39540,Bus,2012,110,39,149
3335,39540,Bus,2013,37,28,65
3336,39540,Bus,2014,123,22,145
3337,39540,Bus,2015,63,75,138
3338,39540,Bus,2016,44,120,164
3339,39540,Bus,2017,59,157,216
3340,39540,Bus,2018,66,181,247
3341,39580,Bus,2002,281,139,420
3342,39580,Bus,2003,434,300,734
3343,39580,Bus,2004,197,287,484
3344,39580,Bus,2005,266,230,496
3345,39580,Bus,2006,372,179,551
3346,39580,Bus,2007,419,110,529
3347,39580,Bus,2012,318,10,328
3348,39580,Bus,2013,296,8,304
3349,39580,Bus,2014,286,10,296
3350,39580,Bus,2015,401,26,427
3351,39580,Bus,2016,513,86,599
3352,39580,Bus,2017,549,97,646
3353,39580,Bus,2018,616,73,689
3354,39660,Bus,2002,7,3,10
3355,39660,Bus,2003,1,5,6
3356,39660,Bus,2004,2,4,6
3357,39660,Bus,2005,1,5,6
3358,39660,Bus,2006,1,2,3
3359,39660,Bus,2007,0,0,0
3360,39660,Bus,2012,0,0,0
3361,39660,Bus,2013,0,0,0
3362,39660,Bus,2014,0,0,0
3363,39660,Bus,2015,0,0,0
3364,39660,Bus,2016,0,0,0
3365,39660,Bus,2017,0,0,0
3366,39660,Bus,2018,0,0,0
3367,39740,Bus,2002,234,478,712
3368,39740,Bus,2003,231,624,855
3369,39740,Bus,2004,224,815,1039
3370,39740,Bus,2005,328,513,841
3371,39740,Bus,2006,267,618,885
3372,39740,Bus,2007,216,351,567
3373,39740,Bus,2012,174,471,645
3374,39740,Bus,2013,219,532,751
3375,39740,Bus,2014,282,478,760
3376,39740,Bus,2015,247,452,699
3377,39740,Bus,2016,228,372,600
3378,39740,Bus,2017,4,21,25
3379,39740,Bus,2018,4,95,99
3380,39820,Bus,2002,0,0,0
3381,39820,Bus,2003,0,0,0
3382,39820,Bus,2004,0,0,0
3383,39820,Bus,2005,0,0,0
3384,39820,Bus,2006,0,0,0
3385,39820,Bus,2007,0,0,0
3386,39820,Bus,2012,6,12,18
3387,39820,Bus,2013,6,12,18
3388,39820,Bus,2014,7,10,17
3389,39820,Bus,2015,7,13,20
3390,39820,Bus,2016,4,10,14
3391,39820,Bus,2017,21,44,65
3392,39820,Bus,2018,4,51,55
3393,39900,Bus,2002,691,281,972
3394,39900,Bus,2003,668,272,940
3395,39900,Bus,2004,701,309,1010
3396,39900,Bus,2005,736,353,1089
3397,39900,Bus,2006,794,391,1185
3398,39900,Bus,2007,864,415,1279
3399,39900,Bus,2012,70,55,125
3400,39900,Bus,2013,132,55,187
3401,39900,Bus,2014,141,48,189
3402,39900,Bus,2015,98,33,131
3403,39900,Bus,2016,98,14,112
3404,39900,Bus,2017,95,6,101
3405,39900,Bus,2018,142,35,177
3406,40060,Bus,2002,1266,755,2021
3407,40060,Bus,2003,1349,563,1912
3408,40060,Bus,2004,998,238,1236
3409,40060,Bus,2005,1084,259,1343
3410,40060,Bus,2006,1322,330,1652
3411,40060,Bus,2007,1378,301,1679
3412,40060,Bus,2012,1081,184,1265
3413,40060,Bus,2013,967,136,1103
3414,40060,Bus,2014,797,111,908
3415,40060,Bus,2015,543,90,633
3416,40060,Bus,2016,767,94,861
3417,40060,Bus,2017,764,87,851
3418,40060,Bus,2018,854,53,907
3419,40140,Bus,2002,1674,1388,3062
3420,40140,Bus,2003,2083,1951,4034
3421,40140,Bus,2004,1687,1882,3569
3422,40140,Bus,2005,2288,1616,3904
3423,40140,Bus,2006,2199,1492,3691
3424,40140,Bus,2007,2582,1582,4164
3425,40140,Bus,2012,1088,2472,3560
3426,40140,Bus,2013,1240,1664,2904
3427,40140,Bus,2014,1269,1476,2745
3428,40140,Bus,2015,1408,1073,2481
3429,40140,Bus,2016,1575,1222,2797
3430,40140,Bus,2017,1605,1077,2682
3431,40140,Bus,2018,1745,1322,3067
3432,40220,Bus,2002,6,251,257
3433,40220,Bus,2003,5,284,289
3434,40220,Bus,2004,7,272,279
3435,40220,Bus,2005,13,251,264
3436,40220,Bus,2006,47,246,293
3437,40220,Bus,2007,4,241,245
3438,40220,Bus,2012,0,223,223
3439,40220,Bus,2013,2,218,220
3440,40220,Bus,2014,2,278,280
3441,40220,Bus,2015,2,291,293
3442,40220,Bus,2016,2,294,296
3443,40220,Bus,2017,1,308,309
3444,40220,Bus,2018,0,241,241
3445,40340,Bus,2002,0,0,0
3446,40340,Bus,2003,0,0,0
3447,40340,Bus,2004,0,0,0
3448,40340,Bus,2005,0,0,0
3449,40340,Bus,2006,0,0,0
3450,40340,Bus,2007,0,0,0
3451,40340,Bus,2012,51,19,70
3452,40340,Bus,2013,66,44,110
3453,40340,Bus,2014,71,39,110
3454,40340,Bus,2015,76,29,105
3455,40340,Bus,2016,117,50,167
3456,40340,Bus,2017,60,83,143
3457,40340,Bus,2018,77,93,170
3458,40380,Bus,2002,463,73,536
3459,40380,Bus,2003,608,132,740
3460,40380,Bus,2004,381,1907,2288
3461,40380,Bus,2005,349,1806,2155
3462,40380,Bus,2006,101,1351,1452
3463,40380,Bus,2007,187,1040,1227
3464,40380,Bus,2012,327,458,785
3465,40380,Bus,2013,439,535,974
3466,40380,Bus,2014,346,509,855
3467,40380,Bus,2015,327,108,435
3468,40380,Bus,2016,343,86,429
3469,40380,Bus,2017,307,77,384
3470,40380,Bus,2018,284,71,355
3471,40420,Bus,2002,121,119,240
3472,40420,Bus,2003,144,125,269
3473,40420,Bus,2004,206,73,279
3474,40420,Bus,2005,222,86,308
3475,40420,Bus,2006,239,103,342
3476,40420,Bus,2007,292,136,428
3477,40420,Bus,2012,318,72,390
3478,40420,Bus,2013,269,72,341
3479,40420,Bus,2014,334,94,428
3480,40420,Bus,2015,369,106,475
3481,40420,Bus,2016,333,75,408
3482,40420,Bus,2017,335,100,435
3483,40420,Bus,2018,350,82,432
3484,40660,Bus,2002,70,39,109
3485,40660,Bus,2003,80,41,121
3486,40660,Bus,2004,83,26,109
3487,40660,Bus,2005,56,19,75
3488,40660,Bus,2006,107,81,188
3489,40660,Bus,2007,149,214,363
3490,40660,Bus,2012,90,69,159
3491,40660,Bus,2013,95,163,258
3492,40660,Bus,2014,43,75,118
3493,40660,Bus,2015,52,50,102
3494,40660,Bus,2016,94,19,113
3495,40660,Bus,2017,83,26,109
3496,40660,Bus,2018,76,59,135
3497,40900,Bus,2002,1189,101,1290
3498,40900,Bus,2003,1058,14,1072
3499,40900,Bus,2004,1703,341,2044
3500,40900,Bus,2005,1586,428,2014
3501,40900,Bus,2006,1345,557,1902
3502,40900,Bus,2007,844,523,1367
3503,40900,Bus,2012,854,289,1143
3504,40900,Bus,2013,1068,301,1369
3505,40900,Bus,2014,1023,122,1145
3506,40900,Bus,2015,1106,187,1293
3507,40900,Bus,2016,1366,255,1621
3508,40900,Bus,2017,1129,332,1461
3509,40900,Bus,2018,1053,321,1374
3510,40900,Rail,2002,33,7,40
3511,40900,Rail,2003,42,99,141
3512,40900,Rail,2004,70,85,155
3513,40900,Rail,2005,264,11,275
3514,40900,Rail,2006,198,58,256
3515,40900,Rail,2007,231,98,329
3516,40900,Rail,2012,49,40,89
3517,40900,Rail,2013,217,29,246
3518,40900,Rail,2014,215,45,260
3519,40900,Rail,2015,239,73,312
3520,40900,Rail,2016,202,167,369
3521,40900,Rail,2017,381,53,434
3522,40900,Rail,2018,399,109,508
3523,40980,Bus,2002,3,0,3
3524,40980,Bus,2003,2,30,32
3525,40980,Bus,2004,4,66,70
3526,40980,Bus,2005,49,108,157
3527,40980,Bus,2006,44,189,233
3528,40980,Bus,2007,54,166,220
3529,40980,Bus,2012,17,99,116
3530,40980,Bus,2013,13,88,101
3531,40980,Bus,2014,63,15,78
3532,40980,Bus,2015,18,81,99
3533,40980,Bus,2016,5,100,105
3534,40980,Bus,2017,13,60,73
3535,40980,Bus,2018,42,30,72
3536,41060,Bus,2002,9,7,16
3537,41060,Bus,2003,5,4,9
3538,41060,Bus,2004,10,1,11
3539,41060,Bus,2005,14,2,16
3540,41060,Bus,2006,14,1,15
3541,41060,Bus,2007,9,0,9
3542,41060,Bus,2012,76,38,114
3543,41060,Bus,2013,87,44,131
3544,41060,Bus,2014,39,36,75
3545,41060,Bus,2015,30,8,38
3546,41060,Bus,2016,25,20,45
3547,41060,Bus,2017,45,81,126
3548,41060,Bus,2018,27,87,114
3549,41140,Bus,2002,36,56,92
3550,41140,Bus,2003,32,66,98
3551,41140,Bus,2004,30,61,91
3552,41140,Bus,2005,25,52,77
3553,41140,Bus,2006,3,40,43
3554,41140,Bus,2007,2,34,36
3555,41140,Bus,2012,0,0,0
3556,41140,Bus,2013,0,0,0
3557,41140,Bus,2014,0,0,0
3558,41140,Bus,2015,0,0,0
3559,41140,Bus,2016,0,0,0
3560,41140,Bus,2017,0,0,0
3561,41140,Bus,2018,0,0,0
3562,41180,Bus,2002,1327,445,1772
3563,41180,Bus,2003,747,264,1011
3564,41180,Bus,2004,716,129,845
3565,41180,Bus,2005,660,157,817
3566,41180,Bus,2006,604,160,764
3567,41180,Bus,2007,552,144,696
3568,41180,Bus,2012,522,251,773
3569,41180,Bus,2013,452,227,679
3570,41180,Bus,2014,507,214,721
3571,41180,Bus,2015,481,222,703
3572,41180,Bus,2016,618,233,851
3573,41180,Bus,2017,670,204,874
3574,41180,Bus,2018,600,210,810
3575,41180,Rail,2002,1,296,297
3576,41180,Rail,2003,3,329,332
3577,41180,Rail,2004,2,326,328
3578,41180,Rail,2005,3,328,331
3579,41180,Rail,2006,7,291,298
3580,41180,Rail,2007,8,333,341
3581,41180,Rail,2012,205,89,294
3582,41180,Rail,2013,278,118,396
3583,41180,Rail,2014,298,86,384
3584,41180,Rail,2015,240,80,320
3585,41180,Rail,2016,296,78,374
3586,41180,Rail,2017,286,71,357
3587,41180,Rail,2018,282,45,327
3588,41420,Bus,2002,68,15,83
3589,41420,Bus,2003,45,16,61
3590,41420,Bus,2004,73,13,86
3591,41420,Bus,2005,64,22,86
3592,41420,Bus,2006,53,18,71
3593,41420,Bus,2007,60,18,78
3594,41420,Bus,2012,139,109,248
3595,41420,Bus,2013,175,112,287
3596,41420,Bus,2014,176,70,246
3597,41420,Bus,2015,169,104,273
3598,41420,Bus,2016,214,131,345
3599,41420,Bus,2017,214,131,345
3600,41420,Bus,2018,189,103,292
3601,41500,Bus,2002,426,476,902
3602,41500,Bus,2003,266,342,608
3603,41500,Bus,2004,264,134,398
3604,41500,Bus,2005,264,188,452
3605,41500,Bus,2006,326,194,520
3606,41500,Bus,2007,142,141,283
3607,41500,Bus,2012,150,152,302
3608,41500,Bus,2013,213,66,279
3609,41500,Bus,2014,251,48,299
3610,41500,Bus,2015,233,39,272
3611,41500,Bus,2016,280,52,332
3612,41500,Bus,2017,247,81,328
3613,41500,Bus,2018,250,59,309
3614,41540,Bus,2002,0,0,0
3615,41540,Bus,2003,0,0,0
3616,41540,Bus,2004,0,0,0
3617,41540,Bus,2005,0,0,0
3618,41540,Bus,2006,166,280,446
3619,41540,Bus,2007,274,169,443
3620,41540,Bus,2012,121,84,205
3621,41540,Bus,2013,134,39,173
3622,41540,Bus,2014,218,96,314
3623,41540,Bus,2015,205,97,302
3624,41540,Bus,2016,262,55,317
3625,41540,Bus,2017,196,72,268
3626,41540,Bus,2018,115,72,187
3627,41620,Bus,2002,29,154,183
3628,41620,Bus,2003,48,224,272
3629,41620,Bus,2004,1625,213,1838
3630,41620,Bus,2005,1507,169,1676
3631,41620,Bus,2006,1428,189,1617
3632,41620,Bus,2007,1516,157,1673
3633,41620,Bus,2012,1217,106,1323
3634,41620,Bus,2013,1162,101,1263
3635,41620,Bus,2014,1050,124,1174
3636,41620,Bus,2015,1857,397,2254
3637,41620,Bus,2016,1010,654,1664
3638,41620,Bus,2017,991,580,1571
3639,41620,Bus,2018,780,579,1359
3640,41620,Rail,2002,4,20,24
3641,41620,Rail,2003,3,10,13
3642,41620,Rail,2004,22,0,22
3643,41620,Rail,2005,65,0,65
3644,41620,Rail,2006,151,0,151
3645,41620,Rail,2007,106,0,106
3646,41620,Rail,2012,69,16,85
3647,41620,Rail,2013,69,19,88
3648,41620,Rail,2014,30,70,100
3649,41620,Rail,2015,178,118,296
3650,41620,Rail,2016,241,79,320
3651,41620,Rail,2017,253,196,449
3652,41620,Rail,2018,355,258,613
3653,41660,Bus,2002,98,81,179
3654,41660,Bus,2003,85,37,122
3655,41660,Bus,2004,51,32,83
3656,41660,Bus,2005,131,143,274
3657,41660,Bus,2006,108,144,252
3658,41660,Bus,2007,80,148,228
3659,41660,Bus,2012,17,62,79
3660,41660,Bus,2013,17,17,34
3661,41660,Bus,2014,42,22,64
3662,41660,Bus,2015,18,7,25
3663,41660,Bus,2016,16,18,34
3664,41660,Bus,2017,65,64,129
3665,41660,Bus,2018,18,71,89
3666,41700,Bus,2002,4255,2692,6947
3667,41700,Bus,2003,8005,973,8978
3668,41700,Bus,2004,5926,2554,8480
3669,41700,Bus,2005,7100,2006,9106
3670,41700,Bus,2006,6428,2604,9032
3671,41700,Bus,2007,4178,1790,5968
3672,41700,Bus,2012,3735,2418,6153
3673,41700,Bus,2013,3204,2852,6056
3674,41700,Bus,2014,4487,6017,10504
3675,41700,Bus,2015,3574,2045,5619
3676,41700,Bus,2016,1706,5400,7106
3677,41700,Bus,2017,5698,925,6623
3678,41700,Bus,2018,2414,3231,5645
3679,41740,Bus,2002,4122,1600,5722
3680,41740,Bus,2003,1809,725,2534
3681,41740,Bus,2004,1613,260,1873
3682,41740,Bus,2005,962,631,1593
3683,41740,Bus,2006,848,670,1518
3684,41740,Bus,2007,949,236,1185
3685,41740,Bus,2012,2175,709,2884
3686,41740,Bus,2013,2302,391,2693
3687,41740,Bus,2014,2423,1260,3683
3688,41740,Bus,2015,2572,281,2853
3689,41740,Bus,2016,3215,697,3912
3690,41740,Bus,2017,3072,632,3704
3691,41740,Bus,2018,2880,448,3328
3692,41740,Rail,2002,18,175,193
3693,41740,Rail,2003,1,164,165
3694,41740,Rail,2004,2,148,150
3695,41740,Rail,2005,3,138,141
3696,41740,Rail,2006,0,196,196
3697,41740,Rail,2007,35,409,444
3698,41740,Rail,2012,25,3223,3248
3699,41740,Rail,2013,30,1714,1744
3700,41740,Rail,2014,26,1559,1585
3701,41740,Rail,2015,409,986,1395
3702,41740,Rail,2016,471,927,1398
3703,41740,Rail,2017,508,975,1483
3704,41740,Rail,2018,445,542,987
3705,41860,Bus,2002,12701,5786,18487
3706,41860,Bus,2003,12422,6364,18786
3707,41860,Bus,2004,9351,6137,15488
3708,41860,Bus,2005,9610,6539,16149
3709,41860,Bus,2006,10075,5306,15381
3710,41860,Bus,2007,8871,6190,15061
3711,41860,Bus,2012,8340,2962,11302
3712,41860,Bus,2013,7422,2655,10077
3713,41860,Bus,2014,6949,2628,9577
3714,41860,Bus,2015,6771,2209,8980
3715,41860,Bus,2016,6734,2341,9075
3716,41860,Bus,2017,5887,3087,8974
3717,41860,Bus,2018,6155,2112,8267
3718,41860,Rail,2002,3412,318,3730
3719,41860,Rail,2003,2804,347,3151
3720,41860,Rail,2004,3182,446,3628
3721,41860,Rail,2005,3017,400,3417
3722,41860,Rail,2006,3286,423,3709
3723,41860,Rail,2007,3386,1103,4489
3724,41860,Rail,2012,1991,7959,9950
3725,41860,Rail,2013,1863,8801,10664
3726,41860,Rail,2014,2102,8436,10538
3727,41860,Rail,2015,1664,8436,10100
3728,41860,Rail,2016,1474,7463,8937
3729,41860,Rail,2017,1542,4772,6314
3730,41860,Rail,2018,1781,3091,4872
3731,41940,Bus,2002,5582,1320,6902
3732,41940,Bus,2003,4067,1004,5071
3733,41940,Bus,2004,3016,542,3558
3734,41940,Bus,2005,2917,597,3514
3735,41940,Bus,2006,3430,751,4181
3736,41940,Bus,2007,3346,716,4062
3737,41940,Bus,2012,1677,346,2023
3738,41940,Bus,2013,1450,299,1749
3739,41940,Bus,2014,1792,435,2227
3740,41940,Bus,2015,1865,366,2231
3741,41940,Bus,2016,1899,302,2201
3742,41940,Bus,2017,1785,372,2157
3743,41940,Bus,2018,1620,321,1941
3744,41940,Rail,2002,96,2,98
3745,41940,Rail,2003,53,0,53
3746,41940,Rail,2004,86,0,86
3747,41940,Rail,2005,72,0,72
3748,41940,Rail,2006,80,3,83
3749,41940,Rail,2007,86,0,86
3750,41940,Rail,2012,67,2,69
3751,41940,Rail,2013,54,0,54
3752,41940,Rail,2014,59,0,59
3753,41940,Rail,2015,110,0,110
3754,41940,Rail,2016,95,0,95
3755,41940,Rail,2017,84,0,84
3756,41940,Rail,2018,90,0,90
3757,41980,Bus,2002,3744,4164,7908
3758,41980,Bus,2003,4284,4008,8292
3759,41980,Bus,2004,8652,5352,14004
3760,41980,Bus,2005,8352,5124,13476
3761,41980,Bus,2006,8504,5402,13906
3762,41980,Bus,2007,8286,4916,13202
3763,41980,Bus,2012,2265,1541,3806
3764,41980,Bus,2013,3032,1729,4761
3765,41980,Bus,2014,4058,2889,6947
3766,41980,Bus,2015,3405,2170,5575
3767,41980,Bus,2016,3343,3801,7144
3768,41980,Bus,2017,3697,3265,6962
3769,41980,Bus,2018,3354,1973,5327
3770,41980,Rail,2002,0,0,0
3771,41980,Rail,2003,0,0,0
3772,41980,Rail,2004,0,0,0
3773,41980,Rail,2005,0,0,0
3774,41980,Rail,2006,0,0,0
3775,41980,Rail,2007,0,0,0
3776,41980,Rail,2012,32,738,770
3777,41980,Rail,2013,34,556,590
3778,41980,Rail,2014,41,481,522
3779,41980,Rail,2015,48,474,522
3780,41980,Rail,2016,42,491,533
3781,41980,Rail,2017,51,524,575
3782,41980,Rail,2018,39,430,469
3783,42020,Bus,2002,0,0,0
3784,42020,Bus,2003,0,0,0
3785,42020,Bus,2004,0,0,0
3786,42020,Bus,2005,0,0,0
3787,42020,Bus,2006,0,0,0
3788,42020,Bus,2007,0,0,0
3789,42020,Bus,2012,144,25,169
3790,42020,Bus,2013,133,43,176
3791,42020,Bus,2014,109,58,167
3792,42020,Bus,2015,93,63,156
3793,42020,Bus,2016,99,51,150
3794,42020,Bus,2017,97,73,170
3795,42020,Bus,2018,91,110,201
3796,42060,Bus,2002,223,85,308
3797,42060,Bus,2003,260,100,360
3798,42060,Bus,2004,383,231,614
3799,42060,Bus,2005,208,173,381
3800,42060,Bus,2006,228,190,418
3801,42060,Bus,2007,316,107,423
3802,42060,Bus,2012,574,153,727
3803,42060,Bus,2013,482,129,611
3804,42060,Bus,2014,400,133,533
3805,42060,Bus,2015,420,189,609
3806,42060,Bus,2016,445,216,661
3807,42060,Bus,2017,61,388,449
3808,42060,Bus,2018,90,376,466
3809,42100,Bus,2002,116,153,269
3810,42100,Bus,2003,64,122,186
3811,42100,Bus,2004,116,246,362
3812,42100,Bus,2005,163,181,344
3813,42100,Bus,2006,96,185,281
3814,42100,Bus,2007,78,208,286
3815,42100,Bus,2012,261,37,298
3816,42100,Bus,2013,263,46,309
3817,42100,Bus,2014,209,69,278
3818,42100,Bus,2015,140,54,194
3819,42100,Bus,2016,30,159,189
3820,42100,Bus,2017,29,248,277
3821,42100,Bus,2018,285,14,299
3822,42140,Bus,2002,112,156,268
3823,42140,Bus,2003,199,36,235
3824,42140,Bus,2004,284,111,395
3825,42140,Bus,2005,290,828,1118
3826,42140,Bus,2006,275,1130,1405
3827,42140,Bus,2007,389,935,1324
3828,42140,Bus,2012,23,92,115
3829,42140,Bus,2013,33,79,112
3830,42140,Bus,2014,43,14,57
3831,42140,Bus,2015,13,31,44
3832,42140,Bus,2016,15,37,52
3833,42140,Bus,2017,12,35,47
3834,42140,Bus,2018,17,42,59
3835,42220,Bus,2002,13,0,13
3836,42220,Bus,2003,8,0,8
3837,42220,Bus,2004,2,0,2
3838,42220,Bus,2005,5,0,5
3839,42220,Bus,2006,4,0,4
3840,42220,Bus,2007,9,0,9
3841,42220,Bus,2012,108,183,291
3842,42220,Bus,2013,104,330,434
3843,42220,Bus,2014,117,282,399
3844,42220,Bus,2015,72,245,317
3845,42220,Bus,2016,107,69,176
3846,42220,Bus,2017,93,41,134
3847,42220,Bus,2018,133,40,173
3848,42340,Bus,2002,521,373,894
3849,42340,Bus,2003,524,182,706
3850,42340,Bus,2004,425,459,884
3851,42340,Bus,2005,382,442,824
3852,42340,Bus,2006,392,430,822
3853,42340,Bus,2007,412,445,857
3854,42340,Bus,2012,284,105,389
3855,42340,Bus,2013,249,98,347
3856,42340,Bus,2014,133,40,173
3857,42340,Bus,2015,147,62,209
3858,42340,Bus,2016,242,58,300
3859,42340,Bus,2017,272,56,328
3860,42340,Bus,2018,262,58,320
3861,42540,Bus,2002,286,173,459
3862,42540,Bus,2003,305,210,515
3863,42540,Bus,2004,341,243,584
3864,42540,Bus,2005,260,192,452
3865,42540,Bus,2006,203,403,606
3866,42540,Bus,2007,219,494,713
3867,42540,Bus,2012,340,1141,1481
3868,42540,Bus,2013,255,2600,2855
3869,42540,Bus,2014,215,1344,1559
3870,42540,Bus,2015,214,1148,1362
3871,42540,Bus,2016,251,1020,1271
3872,42540,Bus,2017,158,643,801
3873,42540,Bus,2018,158,254,412
3874,42660,Bus,2002,11418,776,12194
3875,42660,Bus,2003,2297,534,2831
3876,42660,Bus,2004,2434,419,2853
3877,42660,Bus,2005,2036,361,2397
3878,42660,Bus,2006,10424,6332,16756
3879,42660,Bus,2007,10087,7653,17740
3880,42660,Bus,2012,10824,14375,25199
3881,42660,Bus,2013,11087,11957,23044
3882,42660,Bus,2014,10512,11278,21790
3883,42660,Bus,2015,11173,12194,23367
3884,42660,Bus,2016,12207,11572,23779
3885,42660,Bus,2017,12612,12899,25511
3886,42660,Bus,2018,12006,12801,24807
3887,42660,Rail,2002,0,0,0
3888,42660,Rail,2003,0,0,0
3889,42660,Rail,2004,0,0,0
3890,42660,Rail,2005,2,0,2
3891,42660,Rail,2006,0,1,1
3892,42660,Rail,2007,0,0,0
3893,42660,Rail,2012,138,3,141
3894,42660,Rail,2013,110,28,138
3895,42660,Rail,2014,104,17,121
3896,42660,Rail,2015,116,23,139
3897,42660,Rail,2016,148,124,272
3898,42660,Rail,2017,130,72,202
3899,42660,Rail,2018,131,45,176
3900,42680,Bus,2002,1,1,2
3901,42680,Bus,2003,0,2,2
3902,42680,Bus,2004,0,2,2
3903,42680,Bus,2005,0,0,0
3904,42680,Bus,2006,0,1,1
3905,42680,Bus,2007,0,1,1
3906,42680,Bus,2012,2,5,7
3907,42680,Bus,2013,16,32,48
3908,42680,Bus,2014,2,12,14
3909,42680,Bus,2015,0,5,5
3910,42680,Bus,2016,2,5,7
3911,42680,Bus,2017,2,11,13
3912,42680,Bus,2018,5,9,14
3913,43100,Bus,2002,102,90,192
3914,43100,Bus,2003,78,116,194
3915,43100,Bus,2004,63,68,131
3916,43100,Bus,2005,59,70,129
3917,43100,Bus,2006,28,58,86
3918,43100,Bus,2007,46,26,72
3919,43100,Bus,2012,14,12,26
3920,43100,Bus,2013,17,54,71
3921,43100,Bus,2014,8,57,65
3922,43100,Bus,2015,5,36,41
3923,43100,Bus,2016,5,37,42
3924,43100,Bus,2017,0,0,0
3925,43100,Bus,2018,0,0,0
3926,43300,Bus,2002,0,0,0
3927,43300,Bus,2003,0,0,0
3928,43300,Bus,2004,0,0,0
3929,43300,Bus,2005,0,0,0
3930,43300,Bus,2006,0,0,0
3931,43300,Bus,2007,0,0,0
3932,43300,Bus,2012,12,16,28
3933,43300,Bus,2013,19,27,46
3934,43300,Bus,2014,9,3,12
3935,43300,Bus,2015,0,0,0
3936,43300,Bus,2016,0,0,0
3937,43300,Bus,2017,0,0,0
3938,43300,Bus,2018,0,0,0
3939,43340,Bus,2002,231,67,298
3940,43340,Bus,2003,220,50,270
3941,43340,Bus,2004,280,45,325
3942,43340,Bus,2005,263,32,295
3943,43340,Bus,2006,291,30,321
3944,43340,Bus,2007,269,33,302
3945,43340,Bus,2012,256,18,274
3946,43340,Bus,2013,351,68,419
3947,43340,Bus,2014,536,183,719
3948,43340,Bus,2015,538,312,850
3949,43340,Bus,2016,247,1217,1464
3950,43340,Bus,2017,288,655,943
3951,43340,Bus,2018,333,555,888
3952,43580,Bus,2002,73,132,205
3953,43580,Bus,2003,14,185,199
3954,43580,Bus,2004,10,112,122
3955,43580,Bus,2005,18,64,82
3956,43580,Bus,2006,24,7,31
3957,43580,Bus,2007,21,4,25
3958,43580,Bus,2012,12,46,58
3959,43580,Bus,2013,60,26,86
3960,43580,Bus,2014,19,74,93
3961,43580,Bus,2015,27,86,113
3962,43580,Bus,2016,70,33,103
3963,43580,Bus,2017,125,24,149
3964,43580,Bus,2018,93,82,175
3965,43620,Bus,2002,4,50,54
3966,43620,Bus,2003,33,16,49
3967,43620,Bus,2004,27,4,31
3968,43620,Bus,2005,50,1,51
3969,43620,Bus,2006,0,0,0
3970,43620,Bus,2007,0,0,0
3971,43620,Bus,2012,15,51,66
3972,43620,Bus,2013,17,53,70
3973,43620,Bus,2014,17,47,64
3974,43620,Bus,2015,28,47,75
3975,43620,Bus,2016,29,41,70
3976,43620,Bus,2017,29,9,38
3977,43620,Bus,2018,46,15,61
3978,43780,Bus,2002,108,57,165
3979,43780,Bus,2003,40,26,66
3980,43780,Bus,2004,39,7,46
3981,43780,Bus,2005,113,23,136
3982,43780,Bus,2006,51,16,67
3983,43780,Bus,2007,85,24,109
3984,43780,Bus,2012,139,8,147
3985,43780,Bus,2013,144,9,153
3986,43780,Bus,2014,113,9,122
3987,43780,Bus,2015,137,13,150
3988,43780,Bus,2016,127,26,153
3989,43780,Bus,2017,77,21,98
3990,43780,Bus,2018,86,111,197
3991,44060,Bus,2002,951,623,1574
3992,44060,Bus,2003,991,665,1656
3993,44060,Bus,2004,958,517,1475
3994,44060,Bus,2005,733,505,1238
3995,44060,Bus,2006,731,377,1108
3996,44060,Bus,2007,695,410,1105
3997,44060,Bus,2012,622,224,846
3998,44060,Bus,2013,612,179,791
3999,44060,Bus,2014,647,258,905
4000,44060,Bus,2015,645,199,844
4001,44060,Bus,2016,707,145,852
4002,44060,Bus,2017,691,317,1008
4003,44060,Bus,2018,689,341,1030
4004,44100,Bus,2002,283,37,320
4005,44100,Bus,2003,314,32,346
4006,44100,Bus,2004,64,535,599
4007,44100,Bus,2005,56,517,573
4008,44100,Bus,2006,19,609,628
4009,44100,Bus,2007,25,573,598
4010,44100,Bus,2012,120,551,671
4011,44100,Bus,2013,134,485,619
4012,44100,Bus,2014,102,369,471
4013,44100,Bus,2015,125,316,441
4014,44100,Bus,2016,109,277,386
4015,44100,Bus,2017,106,288,394
4016,44100,Bus,2018,92,234,326
4017,44140,Bus,2002,0,0,0
4018,44140,Bus,2003,0,0,0
4019,44140,Bus,2004,0,0,0
4020,44140,Bus,2005,0,0,0
4021,44140,Bus,2006,0,0,0
4022,44140,Bus,2007,0,0,0
4023,44140,Bus,2012,361,2196,2557
4024,44140,Bus,2013,611,1834,2445
4025,44140,Bus,2014,749,2275,3024
4026,44140,Bus,2015,1027,2672,3699
4027,44140,Bus,2016,900,2517,3417
4028,44140,Bus,2017,873,2501,3374
4029,44140,Bus,2018,1073,2899,3972
4030,44180,Bus,2002,425,772,1197
4031,44180,Bus,2003,354,1054,1408
4032,44180,Bus,2004,338,1069,1407
4033,44180,Bus,2005,422,757,1179
4034,44180,Bus,2006,333,1074,1407
4035,44180,Bus,2007,277,747,1024
4036,44180,Bus,2012,246,875,1121
4037,44180,Bus,2013,280,1014,1294
4038,44180,Bus,2014,347,913,1260
4039,44180,Bus,2015,297,802,1099
4040,44180,Bus,2016,284,781,1065
4041,44180,Bus,2017,69,306,375
4042,44180,Bus,2018,36,286,322
4043,44220,Bus,2002,0,35,35
4044,44220,Bus,2003,1,3,4
4045,44220,Bus,2004,0,3,3
4046,44220,Bus,2005,6,0,6
4047,44220,Bus,2006,5,0,5
4048,44220,Bus,2007,0,0,0
4049,44220,Bus,2012,0,0,0
4050,44220,Bus,2013,0,0,0
4051,44220,Bus,2014,0,0,0
4052,44220,Bus,2015,0,0,0
4053,44220,Bus,2016,0,0,0
4054,44220,Bus,2017,0,0,0
4055,44220,Bus,2018,0,0,0
4056,44300,Bus,2002,173,340,513
4057,44300,Bus,2003,256,379,635
4058,44300,Bus,2004,224,318,542
4059,44300,Bus,2005,246,309,555
4060,44300,Bus,2006,368,217,585
4061,44300,Bus,2007,519,215,734
4062,44300,Bus,2012,41,649,690
4063,44300,Bus,2013,54,425,479
4064,44300,Bus,2014,77,354,431
4065,44300,Bus,2015,55,388,443
4066,44300,Bus,2016,63,397,460
4067,44300,Bus,2017,83,307,390
4068,44300,Bus,2018,81,51,132
4069,44700,Bus,2002,75,765,840
4070,44700,Bus,2003,192,235,427
4071,44700,Bus,2004,186,406,592
4072,44700,Bus,2005,391,212,603
4073,44700,Bus,2006,452,408,860
4074,44700,Bus,2007,453,457,910
4075,44700,Bus,2012,480,648,1128
4076,44700,Bus,2013,314,144,458
4077,44700,Bus,2014,284,234,518
4078,44700,Bus,2015,297,338,635
4079,44700,Bus,2016,364,175,539
4080,44700,Bus,2017,290,249,539
4081,44700,Bus,2018,178,208,386
4082,44700,Rail,2002,0,0,0
4083,44700,Rail,2003,0,0,0
4084,44700,Rail,2004,0,0,0
4085,44700,Rail,2005,0,0,0
4086,44700,Rail,2006,0,0,0
4087,44700,Rail,2007,0,0,0
4088,44700,Rail,2012,1,0,1
4089,44700,Rail,2013,0,0,0
4090,44700,Rail,2014,2,0,2
4091,44700,Rail,2015,2,1,3
4092,44700,Rail,2016,6,0,6
4093,44700,Rail,2017,12,0,12
4094,44700,Rail,2018,8,0,8
4095,44940,Bus,2002,81,155,236
4096,44940,Bus,2003,48,118,166
4097,44940,Bus,2004,225,101,326
4098,44940,Bus,2005,197,90,287
4099,44940,Bus,2006,206,83,289
4100,44940,Bus,2007,317,145,462
4101,44940,Bus,2012,73,309,382
4102,44940,Bus,2013,194,326,520
4103,44940,Bus,2014,243,479,722
4104,44940,Bus,2015,296,422,718
4105,44940,Bus,2016,284,275,559
4106,44940,Bus,2017,170,228,398
4107,44940,Bus,2018,144,256,400
4108,45060,Bus,2002,556,358,914
4109,45060,Bus,2003,694,428,1122
4110,45060,Bus,2004,858,434,1292
4111,45060,Bus,2005,794,503,1297
4112,45060,Bus,2006,408,216,624
4113,45060,Bus,2007,460,263,723
4114,45060,Bus,2012,362,552,914
4115,45060,Bus,2013,388,582,970
4116,45060,Bus,2014,303,309,612
4117,45060,Bus,2015,377,1142,1519
4118,45060,Bus,2016,490,1320,1810
4119,45060,Bus,2017,564,1133,1697
4120,45060,Bus,2018,350,1010,1360
4121,45220,Bus,2002,83,10,93
4122,45220,Bus,2003,79,12,91
4123,45220,Bus,2004,69,78,147
4124,45220,Bus,2005,76,84,160
4125,45220,Bus,2006,71,68,139
4126,45220,Bus,2007,68,52,120
4127,45220,Bus,2012,59,89,148
4128,45220,Bus,2013,42,104,146
4129,45220,Bus,2014,21,132,153
4130,45220,Bus,2015,12,150,162
4131,45220,Bus,2016,12,158,170
4132,45220,Bus,2017,42,168,210
4133,45220,Bus,2018,59,166,225
4134,45300,Bus,2002,1726,417,2143
4135,45300,Bus,2003,1839,2328,4167
4136,45300,Bus,2004,2874,1190,4064
4137,45300,Bus,2005,3784,1695,5479
4138,45300,Bus,2006,1677,2101,3778
4139,45300,Bus,2007,2417,1102,3519
4140,45300,Bus,2012,2493,820,3313
4141,45300,Bus,2013,2237,1254,3491
4142,45300,Bus,2014,3000,1184,4184
4143,45300,Bus,2015,2490,1796,4286
4144,45300,Bus,2016,2189,1118,3307
4145,45300,Bus,2017,1783,1044,2827
4146,45300,Bus,2018,1744,665,2409
4147,45300,Rail,2002,0,0,0
4148,45300,Rail,2003,37,3,40
4149,45300,Rail,2004,9,3,12
4150,45300,Rail,2005,7,4,11
4151,45300,Rail,2006,4,34,38
4152,45300,Rail,2007,6,57,63
4153,45300,Rail,2012,10,7,17
4154,45300,Rail,2013,128,12,140
4155,45300,Rail,2014,80,49,129
4156,45300,Rail,2015,88,23,111
4157,45300,Rail,2016,95,21,116
4158,45300,Rail,2017,167,74,241
4159,45300,Rail,2018,126,15,141
4160,45460,Bus,2002,20,18,38
4161,45460,Bus,2003,21,10,31
4162,45460,Bus,2004,11,0,11
4163,45460,Bus,2005,15,10,25
4164,45460,Bus,2006,28,15,43
4165,45460,Bus,2007,31,22,53
4166,45460,Bus,2012,34,36,70
4167,45460,Bus,2013,62,43,105
4168,45460,Bus,2014,72,64,136
4169,45460,Bus,2015,33,27,60
4170,45460,Bus,2016,24,41,65
4171,45460,Bus,2017,57,40,97
4172,45460,Bus,2018,39,24,63
4173,45780,Bus,2002,966,1256,2222
4174,45780,Bus,2003,629,990,1619
4175,45780,Bus,2004,1402,677,2079
4176,45780,Bus,2005,1694,825,2519
4177,45780,Bus,2006,932,1222,2154
4178,45780,Bus,2007,516,1400,1916
4179,45780,Bus,2012,224,793,1017
4180,45780,Bus,2013,247,826,1073
4181,45780,Bus,2014,299,917,1216
4182,45780,Bus,2015,206,1141,1347
4183,45780,Bus,2016,120,1371,1491
4184,45780,Bus,2017,120,1371,1491
4185,45780,Bus,2018,498,801,1299
4186,45820,Bus,2002,22,36,58
4187,45820,Bus,2003,42,17,59
4188,45820,Bus,2004,27,21,48
4189,45820,Bus,2005,28,19,47
4190,45820,Bus,2006,10,25,35
4191,45820,Bus,2007,27,18,45
4192,45820,Bus,2012,69,378,447
4193,45820,Bus,2013,75,158,233
4194,45820,Bus,2014,50,48,98
4195,45820,Bus,2015,29,35,64
4196,45820,Bus,2016,25,30,55
4197,45820,Bus,2017,15,25,40
4198,45820,Bus,2018,24,21,45
4199,46060,Bus,2002,4685,1620,6305
4200,46060,Bus,2003,4430,730,5160
4201,46060,Bus,2004,3850,1076,4926
4202,46060,Bus,2005,1152,1193,2345
4203,46060,Bus,2006,1331,1370,2701
4204,46060,Bus,2007,1167,1842,3009
4205,46060,Bus,2012,1123,334,1457
4206,46060,Bus,2013,1194,352,1546
4207,46060,Bus,2014,1067,319,1386
4208,46060,Bus,2015,752,160,912
4209,46060,Bus,2016,905,289,1194
4210,46060,Bus,2017,922,317,1239
4211,46060,Bus,2018,1102,393,1495
4212,46060,Rail,2002,0,0,0
4213,46060,Rail,2003,0,0,0
4214,46060,Rail,2004,0,0,0
4215,46060,Rail,2005,0,0,0
4216,46060,Rail,2006,0,0,0
4217,46060,Rail,2007,0,0,0
4218,46060,Rail,2012,0,0,0
4219,46060,Rail,2013,0,0,0
4220,46060,Rail,2014,0,0,0
4221,46060,Rail,2015,88,37,125
4222,46060,Rail,2016,26,15,41
4223,46060,Rail,2017,18,54,72
4224,46060,Rail,2018,15,66,81
4225,46140,Bus,2002,468,122,590
4226,46140,Bus,2003,101,250,351
4227,46140,Bus,2004,108,120,228
4228,46140,Bus,2005,99,152,251
4229,46140,Bus,2006,92,124,216
4230,46140,Bus,2007,62,121,183
4231,46140,Bus,2012,250,82,332
4232,46140,Bus,2013,189,46,235
4233,46140,Bus,2014,230,63,293
4234,46140,Bus,2015,177,112,289
4235,46140,Bus,2016,241,107,348
4236,46140,Bus,2017,243,48,291
4237,46140,Bus,2018,266,43,309
4238,46220,Bus,2002,7,0,7
4239,46220,Bus,2003,10,42,52
4240,46220,Bus,2004,17,79,96
4241,46220,Bus,2005,18,119,137
4242,46220,Bus,2006,20,73,93
4243,46220,Bus,2007,32,84,116
4244,46220,Bus,2012,0,0,0
4245,46220,Bus,2013,0,0,0
4246,46220,Bus,2014,0,0,0
4247,46220,Bus,2015,0,0,0
4248,46220,Bus,2016,0,0,0
4249,46220,Bus,2017,0,0,0
4250,46220,Bus,2018,0,0,0
4251,46540,Bus,2002,0,0,0
4252,46540,Bus,2003,0,0,0
4253,46540,Bus,2004,0,0,0
4254,46540,Bus,2005,0,0,0
4255,46540,Bus,2006,88,49,137
4256,46540,Bus,2007,58,84,142
4257,46540,Bus,2012,118,149,267
4258,46540,Bus,2013,98,156,254
4259,46540,Bus,2014,20,0,20
4260,46540,Bus,2015,55,27,82
4261,46540,Bus,2016,0,0,0
4262,46540,Bus,2017,0,0,0
4263,46540,Bus,2018,0,0,0
4264,46700,Bus,2002,0,0,0
4265,46700,Bus,2003,0,0,0
4266,46700,Bus,2004,0,0,0
4267,46700,Bus,2005,0,0,0
4268,46700,Bus,2006,0,0,0
4269,46700,Bus,2007,0,0,0
4270,46700,Bus,2012,194,136,330
4271,46700,Bus,2013,184,206,390
4272,46700,Bus,2014,299,232,531
4273,46700,Bus,2015,301,140,441
4274,46700,Bus,2016,343,106,449
4275,46700,Bus,2017,554,94,648
4276,46700,Bus,2018,515,75,590
4277,47020,Bus,2002,0,0,0
4278,47020,Bus,2003,0,0,0
4279,47020,Bus,2004,16,8,24
4280,47020,Bus,2005,8,8,16
4281,47020,Bus,2006,2,2,4
4282,47020,Bus,2007,5,10,15
4283,47020,Bus,2012,47,111,158
4284,47020,Bus,2013,19,118,137
4285,47020,Bus,2014,26,71,97
4286,47020,Bus,2015,0,0,0
4287,47020,Bus,2016,0,0,0
4288,47020,Bus,2017,0,0,0
4289,47020,Bus,2018,0,0,0
4290,47260,Bus,2002,1601,3461,5062
4291,47260,Bus,2003,2362,3371,5733
4292,47260,Bus,2004,3158,4474,7632
4293,47260,Bus,2005,2742,3942,6684
4294,47260,Bus,2006,2924,3545,6469
4295,47260,Bus,2007,3596,2165,5761
4296,47260,Bus,2012,2575,825,3400
4297,47260,Bus,2013,1672,1092,2764
4298,47260,Bus,2014,2604,261,2865
4299,47260,Bus,2015,2934,1783,4717
4300,47260,Bus,2016,1698,1939,3637
4301,47260,Bus,2017,1200,1659,2859
4302,47260,Bus,2018,1271,1812,3083
4303,47260,Rail,2002,0,0,0
4304,47260,Rail,2003,0,0,0
4305,47260,Rail,2004,0,0,0
4306,47260,Rail,2005,0,0,0
4307,47260,Rail,2006,0,0,0
4308,47260,Rail,2007,0,0,0
4309,47260,Rail,2012,23,25,48
4310,47260,Rail,2013,0,88,88
4311,47260,Rail,2014,68,0,68
4312,47260,Rail,2015,52,3,55
4313,47260,Rail,2016,50,9,59
4314,47260,Rail,2017,34,0,34
4315,47260,Rail,2018,45,0,45
4316,47300,Bus,2002,49,77,126
4317,47300,Bus,2003,50,109,159
4318,47300,Bus,2004,28,79,107
4319,47300,Bus,2005,28,103,131
4320,47300,Bus,2006,29,82,111
4321,47300,Bus,2007,55,66,121
4322,47300,Bus,2012,129,65,194
4323,47300,Bus,2013,112,296,408
4324,47300,Bus,2014,95,286,381
4325,47300,Bus,2015,123,250,373
4326,47300,Bus,2016,73,261,334
4327,47300,Bus,2017,46,77,123
4328,47300,Bus,2018,31,100,131
4329,47380,Bus,2002,0,0,0
4330,47380,Bus,2003,2,3,5
4331,47380,Bus,2004,1,2,3
4332,47380,Bus,2005,8,0,8
4333,47380,Bus,2006,17,10,27
4334,47380,Bus,2007,33,6,39
4335,47380,Bus,2012,31,53,84
4336,47380,Bus,2013,132,132,264
4337,47380,Bus,2014,67,6,73
4338,47380,Bus,2015,73,21,94
4339,47380,Bus,2016,60,3,63
4340,47380,Bus,2017,30,1,31
4341,47380,Bus,2018,64,198,262
4342,47900,Bus,2002,5620,4233,9853
4343,47900,Bus,2003,6430,3946,10376
4344,47900,Bus,2004,7478,6889,14367
4345,47900,Bus,2005,7063,2682,9745
4346,47900,Bus,2006,7341,2900,10241
4347,47900,Bus,2007,6426,3302,9728
4348,47900,Bus,2012,6806,5818,12624
4349,47900,Bus,2013,6093,6393,12486
4350,47900,Bus,2014,6501,6192,12693
4351,47900,Bus,2015,7131,4511,11642
4352,47900,Bus,2016,7436,6881,14317
4353,47900,Bus,2017,7965,9540,17505
4354,47900,Bus,2018,9511,8081,17592
4355,47900,Rail,2002,5500,3050,8550
4356,47900,Rail,2003,721,499,1220
4357,47900,Rail,2004,536,339,875
4358,47900,Rail,2005,661,377,1038
4359,47900,Rail,2006,726,542,1268
4360,47900,Rail,2007,706,155,861
4361,47900,Rail,2012,1485,111,1596
4362,47900,Rail,2013,1223,139,1362
4363,47900,Rail,2014,1408,102,1510
4364,47900,Rail,2015,1645,151,1796
4365,47900,Rail,2016,1519,78,1597
4366,47900,Rail,2017,974,78,1052
4367,47900,Rail,2018,664,36,700
4368,47940,Bus,2002,17,215,232
4369,47940,Bus,2003,45,225,270
4370,47940,Bus,2004,36,269,305
4371,47940,Bus,2005,53,319,372
4372,47940,Bus,2006,44,294,338
4373,47940,Bus,2007,33,251,284
4374,47940,Bus,2012,20,153,173
4375,47940,Bus,2013,6,115,121
4376,47940,Bus,2014,0,0,0
4377,47940,Bus,2015,0,0,0
4378,47940,Bus,2016,0,0,0
4379,47940,Bus,2017,0,0,0
4380,47940,Bus,2018,0,0,0
4381,48140,Bus,2002,9,17,26
4382,48140,Bus,2003,11,10,21
4383,48140,Bus,2004,1,1,2
4384,48140,Bus,2005,3,1,4
4385,48140,Bus,2006,4,9,13
4386,48140,Bus,2007,7,29,36
4387,48140,Bus,2012,9,16,25
4388,48140,Bus,2013,14,13,27
4389,48140,Bus,2014,0,0,0
4390,48140,Bus,2015,0,0,0
4391,48140,Bus,2016,0,0,0
4392,48140,Bus,2017,0,0,0
4393,48140,Bus,2018,0,0,0
4394,48300,Bus,2002,0,0,0
4395,48300,Bus,2003,0,0,0
4396,48300,Bus,2004,19,6,25
4397,48300,Bus,2005,10,44,54
4398,48300,Bus,2006,1,135,136
4399,48300,Bus,2007,58,75,133
4400,48300,Bus,2012,119,134,253
4401,48300,Bus,2013,89,90,179
4402,48300,Bus,2014,150,131,281
4403,48300,Bus,2015,190,256,446
4404,48300,Bus,2016,281,140,421
4405,48300,Bus,2017,207,120,327
4406,48300,Bus,2018,152,117,269
4407,48540,Bus,2002,2,54,56
4408,48540,Bus,2003,3,72,75
4409,48540,Bus,2004,5,52,57
4410,48540,Bus,2005,9,76,85
4411,48540,Bus,2006,8,54,62
4412,48540,Bus,2007,4,75,79
4413,48540,Bus,2012,15,147,162
4414,48540,Bus,2013,16,147,163
4415,48540,Bus,2014,1,179,180
4416,48540,Bus,2015,13,195,208
4417,48540,Bus,2016,8,160,168
4418,48540,Bus,2017,1,120,121
4419,48540,Bus,2018,1,115,116
4420,48620,Bus,2002,169,443,612
4421,48620,Bus,2003,302,34,336
4422,48620,Bus,2004,12,8,20
4423,48620,Bus,2005,14,52,66
4424,48620,Bus,2006,49,448,497
4425,48620,Bus,2007,46,486,532
4426,48620,Bus,2012,971,191,1162
4427,48620,Bus,2013,623,604,1227
4428,48620,Bus,2014,519,445,964
4429,48620,Bus,2015,273,28,301
4430,48620,Bus,2016,222,285,507
4431,48620,Bus,2017,186,237,423
4432,48620,Bus,2018,139,218,357
4433,48700,Bus,2002,119,107,226
4434,48700,Bus,2003,115,158,273
4435,48700,Bus,2004,190,157,347
4436,48700,Bus,2005,144,246,390
4437,48700,Bus,2006,115,239,354
4438,48700,Bus,2007,175,301,476
4439,48700,Bus,2012,159,518,677
4440,48700,Bus,2013,93,379,472
4441,48700,Bus,2014,106,393,499
4442,48700,Bus,2015,103,404,507
4443,48700,Bus,2016,119,392,511
4444,48700,Bus,2017,142,111,253
4445,48700,Bus,2018,100,123,223
4446,48900,Bus,2002,186,35,221
4447,48900,Bus,2003,167,13,180
4448,48900,Bus,2004,61,48,109
4449,48900,Bus,2005,44,91,135
4450,48900,Bus,2006,32,51,83
4451,48900,Bus,2007,38,48,86
4452,48900,Bus,2012,41,302,343
4453,48900,Bus,2013,33,278,311
4454,48900,Bus,2014,12,21,33
4455,48900,Bus,2015,297,191,488
4456,48900,Bus,2016,421,269,690
4457,48900,Bus,2017,219,114,333
4458,48900,Bus,2018,92,136,228
4459,49020,Bus,2002,0,0,0
4460,49020,Bus,2003,0,0,0
4461,49020,Bus,2004,0,0,0
4462,49020,Bus,2005,0,0,0
4463,49020,Bus,2006,0,0,0
4464,49020,Bus,2007,0,0,0
4465,49020,Bus,2012,0,0,0
4466,49020,Bus,2013,0,0,0
4467,49020,Bus,2014,0,0,0
4468,49020,Bus,2015,0,0,0
4469,49020,Bus,2016,0,0,0
4470,49020,Bus,2017,0,0,0
4471,49020,Bus,2018,0,0,0
4472,49180,Bus,2002,49,194,243
4473,49180,Bus,2003,77,160,237
4474,49180,Bus,2004,109,86,195
4475,49180,Bus,2005,150,72,222
4476,49180,Bus,2006,79,32,111
4477,49180,Bus,2007,112,106,218
4478,49180,Bus,2012,148,256,404
4479,49180,Bus,2013,137,416,553
4480,49180,Bus,2014,183,488,671
4481,49180,Bus,2015,41,348,389
4482,49180,Bus,2016,15,282,297
4483,49180,Bus,2017,100,90,190
4484,49180,Bus,2018,177,163,340
4485,49340,Bus,2002,677,247,924
4486,49340,Bus,2003,186,276,462
4487,49340,Bus,2004,294,644,938
4488,49340,Bus,2005,288,387,675
4489,49340,Bus,2006,613,267,880
4490,49340,Bus,2007,641,560,1201
4491,49340,Bus,2012,337,779,1116
4492,49340,Bus,2013,274,599,873
4493,49340,Bus,2014,186,846,1032
4494,49340,Bus,2015,207,691,898
4495,49340,Bus,2016,179,826,1005
4496,49340,Bus,2017,215,885,1100
4497,49340,Bus,2018,278,904,1182
4498,49420,Bus,2002,21,9,30
4499,49420,Bus,2003,27,10,37
4500,49420,Bus,2004,27,9,36
4501,49420,Bus,2005,15,9,24
4502,49420,Bus,2006,14,11,25
4503,49420,Bus,2007,3,3,6
4504,49420,Bus,2012,87,51,138
4505,49420,Bus,2013,39,120,159
4506,49420,Bus,2014,33,170,203
4507,49420,Bus,2015,51,68,119
4508,49420,Bus,2016,41,62,103
4509,49420,Bus,2017,49,54,103
4510,49420,Bus,2018,55,89,144
4511,49620,Bus,2002,69,78,147
4512,49620,Bus,2003,48,51,99
4513,49620,Bus,2004,19,22,41
4514,49620,Bus,2005,17,25,42
4515,49620,Bus,2006,12,19,31
4516,49620,Bus,2007,26,15,41
4517,49620,Bus,2012,128,785,913
4518,49620,Bus,2013,113,831,944
4519,49620,Bus,2014,98,728,826
4520,49620,Bus,2015,42,270,312
4521,49620,Bus,2016,35,376,411
4522,49620,Bus,2017,16,818,834
4523,49620,Bus,2018,9,535,544
4524,49660,Bus,2002,20,11,31
4525,49660,Bus,2003,20,52,72
4526,49660,Bus,2004,50,25,75
4527,49660,Bus,2005,69,34,103
4528,49660,Bus,2006,66,15,81
4529,49660,Bus,2007,61,15,76
4530,49660,Bus,2012,114,69,183
4531,49660,Bus,2013,69,51,120
4532,49660,Bus,2014,44,30,74
4533,49660,Bus,2015,57,24,81
4534,49660,Bus,2016,29,19,48
4535,49660,Bus,2017,30,16,46
4536,49660,Bus,2018,21,14,35
4537,49700,Bus,2002,0,0,0
4538,49700,Bus,2003,0,0,0
4539,49700,Bus,2004,0,0,0
4540,49700,Bus,2005,0,0,0
4541,49700,Bus,2006,0,0,0
4542,49700,Bus,2007,0,0,0
4543,49700,Bus,2012,60,32,92
4544,49700,Bus,2013,59,19,78
4545,49700,Bus,2014,2,67,69
4546,49700,Bus,2015,38,5,43
4547,49700,Bus,2016,48,5,53
4548,49700,Bus,2017,60,16,76
4549,49700,Bus,2018,60,21,81
4550,49740,Bus,2002,0,0,0
4551,49740,Bus,2003,0,0,0
4552,49740,Bus,2004,0,0,0
4553,49740,Bus,2005,0,0,0
4554,49740,Bus,2006,0,0,0
4555,49740,Bus,2007,0,0,0
4556,49740,Bus,2012,143,202,345
4557,49740,Bus,2013,48,67,115
4558,49740,Bus,2014,29,39,68
4559,49740,Bus,2015,30,248,278
4560,49740,Bus,2016,107,283,390
4561,49740,Bus,2017,147,50,197
4562,49740,Bus,2018,133,36,169