,CBSA,MNAME,Mode,Year,Mecha_Failures,Other_Failures,Total_Failures,MDBF_Exclude,MDBF_Notes
0,10420,"Akron, OH Metro Area",Bus,2002,76,1279,1355,0,
1,10420,"Akron, OH Metro Area",Bus,2003,19,1409,1428,0,
2,10420,"Akron, OH Metro Area",Bus,2004,67,1254,1321,0,
3,10420,"Akron, OH Metro Area",Bus,2005,169,2369,2538,0,
4,10420,"Akron, OH Metro Area",Bus,2006,166,2236,2402,0,
5,10420,"Akron, OH Metro Area",Bus,2007,144,1230,1374,0,
6,10420,"Akron, OH Metro Area",Bus,2008,187,1390,1577,0,
7,10420,"Akron, OH Metro Area",Bus,2009,201,1319,1520,0,
8,10420,"Akron, OH Metro Area",Bus,2010,216,1221,1437,0,
9,10420,"Akron, OH Metro Area",Bus,2011,138,959,1097,0,
10,10420,"Akron, OH Metro Area",Bus,2012,128,878,1006,0,
11,10420,"Akron, OH Metro Area",Bus,2013,1061,53,1114,0,
12,10420,"Akron, OH Metro Area",Bus,2014,1014,56,1070,0,
13,10420,"Akron, OH Metro Area",Bus,2015,893,60,953,0,
14,10420,"Akron, OH Metro Area",Bus,2016,788,41,829,0,
15,10420,"Akron, OH Metro Area",Bus,2017,232,519,751,0,
16,10420,"Akron, OH Metro Area",Bus,2018,195,644,839,0,
17,10500,"Albany, GA Metro Area",Bus,2002,107,35,142,0,
18,10500,"Albany, GA Metro Area",Bus,2003,77,45,122,0,
19,10500,"Albany, GA Metro Area",Bus,2004,72,23,95,0,
20,10500,"Albany, GA Metro Area",Bus,2005,68,24,92,0,
21,10500,"Albany, GA Metro Area",Bus,2006,59,21,80,0,
22,10500,"Albany, GA Metro Area",Bus,2007,51,11,62,0,
23,10500,"Albany, GA Metro Area",Bus,2008,43,27,70,0,
24,10500,"Albany, GA Metro Area",Bus,2009,49,20,69,0,
25,10500,"Albany, GA Metro Area",Bus,2010,49,23,72,0,
26,10500,"Albany, GA Metro Area",Bus,2011,18,33,51,0,
27,10500,"Albany, GA Metro Area",Bus,2012,40,15,55,0,
28,10500,"Albany, GA Metro Area",Bus,2013,45,6,51,0,
29,10500,"Albany, GA Metro Area",Bus,2014,69,32,101,0,
30,10500,"Albany, GA Metro Area",Bus,2015,33,232,265,0,
31,10500,"Albany, GA Metro Area",Bus,2016,35,291,326,0,
32,10500,"Albany, GA Metro Area",Bus,2017,58,349,407,0,
33,10500,"Albany, GA Metro Area",Bus,2018,70,273,343,0,
34,10580,"Albany-Schenectady-Troy, NY Metro Area",Bus,2002,1016,2466,3482,0,
35,10580,"Albany-Schenectady-Troy, NY Metro Area",Bus,2003,1095,2247,3342,0,
36,10580,"Albany-Schenectady-Troy, NY Metro Area",Bus,2004,12,18,30,0,
37,10580,"Albany-Schenectady-Troy, NY Metro Area",Bus,2005,12,18,30,0,
38,10580,"Albany-Schenectady-Troy, NY Metro Area",Bus,2006,353,139,492,0,
39,10580,"Albany-Schenectady-Troy, NY Metro Area",Bus,2007,176,293,469,0,
40,10580,"Albany-Schenectady-Troy, NY Metro Area",Bus,2008,121,167,288,0,
41,10580,"Albany-Schenectady-Troy, NY Metro Area",Bus,2009,79,178,257,0,
42,10580,"Albany-Schenectady-Troy, NY Metro Area",Bus,2010,73,187,260,0,
43,10580,"Albany-Schenectady-Troy, NY Metro Area",Bus,2011,72,195,267,0,
44,10580,"Albany-Schenectady-Troy, NY Metro Area",Bus,2012,223,442,665,0,
45,10580,"Albany-Schenectady-Troy, NY Metro Area",Bus,2013,289,107,396,0,
46,10580,"Albany-Schenectady-Troy, NY Metro Area",Bus,2014,441,15,456,0,
47,10580,"Albany-Schenectady-Troy, NY Metro Area",Bus,2015,428,1559,1987,0,
48,10580,"Albany-Schenectady-Troy, NY Metro Area",Bus,2016,358,1236,1594,0,
49,10580,"Albany-Schenectady-Troy, NY Metro Area",Bus,2017,454,1234,1688,0,
50,10580,"Albany-Schenectady-Troy, NY Metro Area",Bus,2018,517,1156,1673,0,
51,10740,"Albuquerque, NM Metro Area",Bus,2002,1368,813,2181,0,
52,10740,"Albuquerque, NM Metro Area",Bus,2003,718,1541,2259,0,
53,10740,"Albuquerque, NM Metro Area",Bus,2004,45,314,359,0,
54,10740,"Albuquerque, NM Metro Area",Bus,2005,129,73,202,0,
55,10740,"Albuquerque, NM Metro Area",Bus,2006,879,1644,2523,0,
56,10740,"Albuquerque, NM Metro Area",Bus,2007,882,1299,2181,0,
57,10740,"Albuquerque, NM Metro Area",Bus,2008,777,1068,1845,0,
58,10740,"Albuquerque, NM Metro Area",Bus,2009,493,703,1196,0,
59,10740,"Albuquerque, NM Metro Area",Bus,2010,301,383,684,0,
60,10740,"Albuquerque, NM Metro Area",Bus,2011,316,358,674,0,
61,10740,"Albuquerque, NM Metro Area",Bus,2012,255,420,675,0,
62,10740,"Albuquerque, NM Metro Area",Bus,2013,258,409,667,0,
63,10740,"Albuquerque, NM Metro Area",Bus,2014,182,320,502,0,
64,10740,"Albuquerque, NM Metro Area",Bus,2015,161,338,499,0,
65,10740,"Albuquerque, NM Metro Area",Bus,2016,161,321,482,0,
66,10740,"Albuquerque, NM Metro Area",Bus,2017,233,120,353,0,
67,10740,"Albuquerque, NM Metro Area",Bus,2018,165,134,299,0,
68,10740,"Albuquerque, NM Metro Area",Rail,2002,0,0,0,1,Not reported
69,10740,"Albuquerque, NM Metro Area",Rail,2003,0,0,0,1,Not reported
70,10740,"Albuquerque, NM Metro Area",Rail,2004,0,0,0,1,Not reported
71,10740,"Albuquerque, NM Metro Area",Rail,2005,0,0,0,1,Not reported
72,10740,"Albuquerque, NM Metro Area",Rail,2006,0,0,0,1,Not reported
73,10740,"Albuquerque, NM Metro Area",Rail,2007,0,0,0,1,Not reported
74,10740,"Albuquerque, NM Metro Area",Rail,2008,0,0,0,1,Not reported
75,10740,"Albuquerque, NM Metro Area",Rail,2009,7,0,7,0,
76,10740,"Albuquerque, NM Metro Area",Rail,2010,11,0,11,0,
77,10740,"Albuquerque, NM Metro Area",Rail,2011,11,0,11,0,
78,10740,"Albuquerque, NM Metro Area",Rail,2012,17,3,20,0,
79,10740,"Albuquerque, NM Metro Area",Rail,2013,8,7,15,0,
80,10740,"Albuquerque, NM Metro Area",Rail,2014,9,6,15,0,
81,10740,"Albuquerque, NM Metro Area",Rail,2015,14,10,24,0,
82,10740,"Albuquerque, NM Metro Area",Rail,2016,20,2,22,0,
83,10740,"Albuquerque, NM Metro Area",Rail,2017,13,4,17,0,
84,10740,"Albuquerque, NM Metro Area",Rail,2018,13,8,21,0,
85,10900,"Allentown-Bethlehem-Easton, PA-NJ Metro Area",Bus,2002,174,136,310,0,
86,10900,"Allentown-Bethlehem-Easton, PA-NJ Metro Area",Bus,2003,173,136,309,0,
87,10900,"Allentown-Bethlehem-Easton, PA-NJ Metro Area",Bus,2004,221,153,374,0,
88,10900,"Allentown-Bethlehem-Easton, PA-NJ Metro Area",Bus,2005,202,141,343,0,
89,10900,"Allentown-Bethlehem-Easton, PA-NJ Metro Area",Bus,2006,50,417,467,0,
90,10900,"Allentown-Bethlehem-Easton, PA-NJ Metro Area",Bus,2007,37,410,447,0,
91,10900,"Allentown-Bethlehem-Easton, PA-NJ Metro Area",Bus,2008,36,468,504,0,
92,10900,"Allentown-Bethlehem-Easton, PA-NJ Metro Area",Bus,2009,245,480,725,0,
93,10900,"Allentown-Bethlehem-Easton, PA-NJ Metro Area",Bus,2010,77,388,465,0,
94,10900,"Allentown-Bethlehem-Easton, PA-NJ Metro Area",Bus,2011,24,468,492,0,
95,10900,"Allentown-Bethlehem-Easton, PA-NJ Metro Area",Bus,2012,22,418,440,0,
96,10900,"Allentown-Bethlehem-Easton, PA-NJ Metro Area",Bus,2013,20,364,384,0,
97,10900,"Allentown-Bethlehem-Easton, PA-NJ Metro Area",Bus,2014,24,416,440,0,
98,10900,"Allentown-Bethlehem-Easton, PA-NJ Metro Area",Bus,2015,28,432,460,0,
99,10900,"Allentown-Bethlehem-Easton, PA-NJ Metro Area",Bus,2016,32,456,488,0,
100,10900,"Allentown-Bethlehem-Easton, PA-NJ Metro Area",Bus,2017,46,458,504,0,
101,10900,"Allentown-Bethlehem-Easton, PA-NJ Metro Area",Bus,2018,71,424,495,0,
102,11020,"Altoona, PA Metro Area",Bus,2002,147,62,209,0,
103,11020,"Altoona, PA Metro Area",Bus,2003,172,62,234,0,
104,11020,"Altoona, PA Metro Area",Bus,2004,176,77,253,0,
105,11020,"Altoona, PA Metro Area",Bus,2005,168,98,266,0,
106,11020,"Altoona, PA Metro Area",Bus,2006,127,103,230,0,
107,11020,"Altoona, PA Metro Area",Bus,2007,110,71,181,0,
108,11020,"Altoona, PA Metro Area",Bus,2008,71,77,148,0,
109,11020,"Altoona, PA Metro Area",Bus,2009,80,94,174,0,
110,11020,"Altoona, PA Metro Area",Bus,2010,66,67,133,0,
111,11020,"Altoona, PA Metro Area",Bus,2011,45,80,125,0,
112,11020,"Altoona, PA Metro Area",Bus,2012,40,78,118,0,
113,11020,"Altoona, PA Metro Area",Bus,2013,54,36,90,0,
114,11020,"Altoona, PA Metro Area",Bus,2014,43,41,84,0,
115,11020,"Altoona, PA Metro Area",Bus,2015,47,32,79,0,
116,11020,"Altoona, PA Metro Area",Bus,2016,23,30,53,0,
117,11020,"Altoona, PA Metro Area",Bus,2017,40,36,76,0,
118,11020,"Altoona, PA Metro Area",Bus,2018,63,47,110,0,
119,11180,"Ames, IA Metro Area",Bus,2002,26,145,171,0,
120,11180,"Ames, IA Metro Area",Bus,2003,38,170,208,0,
121,11180,"Ames, IA Metro Area",Bus,2004,35,145,180,0,
122,11180,"Ames, IA Metro Area",Bus,2005,49,157,206,0,
123,11180,"Ames, IA Metro Area",Bus,2006,41,163,204,0,
124,11180,"Ames, IA Metro Area",Bus,2007,38,185,223,0,
125,11180,"Ames, IA Metro Area",Bus,2008,70,189,259,0,
126,11180,"Ames, IA Metro Area",Bus,2009,84,177,261,0,
127,11180,"Ames, IA Metro Area",Bus,2010,75,278,353,0,
128,11180,"Ames, IA Metro Area",Bus,2011,84,266,350,0,
129,11180,"Ames, IA Metro Area",Bus,2012,41,159,200,0,
130,11180,"Ames, IA Metro Area",Bus,2013,44,126,170,0,
131,11180,"Ames, IA Metro Area",Bus,2014,34,152,186,0,
132,11180,"Ames, IA Metro Area",Bus,2015,50,156,206,0,
133,11180,"Ames, IA Metro Area",Bus,2016,43,174,217,0,
134,11180,"Ames, IA Metro Area",Bus,2017,44,234,278,0,
135,11180,"Ames, IA Metro Area",Bus,2018,35,237,272,0,
136,11260,"Anchorage, AK Metro Area",Bus,2002,48,29,77,0,
137,11260,"Anchorage, AK Metro Area",Bus,2003,84,39,123,0,
138,11260,"Anchorage, AK Metro Area",Bus,2004,103,64,167,0,
139,11260,"Anchorage, AK Metro Area",Bus,2005,165,59,224,0,
140,11260,"Anchorage, AK Metro Area",Bus,2006,94,68,162,0,
141,11260,"Anchorage, AK Metro Area",Bus,2007,283,341,624,0,
142,11260,"Anchorage, AK Metro Area",Bus,2008,94,86,180,0,
143,11260,"Anchorage, AK Metro Area",Bus,2009,98,90,188,0,
144,11260,"Anchorage, AK Metro Area",Bus,2010,99,104,203,0,
145,11260,"Anchorage, AK Metro Area",Bus,2011,65,128,193,0,
146,11260,"Anchorage, AK Metro Area",Bus,2012,150,467,617,0,
147,11260,"Anchorage, AK Metro Area",Bus,2013,67,557,624,0,
148,11260,"Anchorage, AK Metro Area",Bus,2014,277,318,595,0,
149,11260,"Anchorage, AK Metro Area",Bus,2015,465,271,736,0,
150,11260,"Anchorage, AK Metro Area",Bus,2016,518,312,830,0,
151,11260,"Anchorage, AK Metro Area",Bus,2017,371,363,734,0,
152,11260,"Anchorage, AK Metro Area",Bus,2018,170,523,693,0,
153,11460,"Ann Arbor, MI Metro Area",Bus,2002,663,241,904,0,
155,11460,"Ann Arbor, MI Metro Area",Bus,2003,587,407,994,0,
157,11460,"Ann Arbor, MI Metro Area",Bus,2004,465,356,821,0,
159,11460,"Ann Arbor, MI Metro Area",Bus,2005,457,360,817,0,
161,11460,"Ann Arbor, MI Metro Area",Bus,2006,405,452,857,0,
163,11460,"Ann Arbor, MI Metro Area",Bus,2007,450,326,776,0,
165,11460,"Ann Arbor, MI Metro Area",Bus,2008,314,356,670,0,
167,11460,"Ann Arbor, MI Metro Area",Bus,2009,285,371,656,0,
169,11460,"Ann Arbor, MI Metro Area",Bus,2010,324,402,726,0,
171,11460,"Ann Arbor, MI Metro Area",Bus,2011,297,369,666,0,
173,11460,"Ann Arbor, MI Metro Area",Bus,2012,275,370,645,0,
175,11460,"Ann Arbor, MI Metro Area",Bus,2013,323,462,785,0,
177,11460,"Ann Arbor, MI Metro Area",Bus,2014,269,389,658,0,
179,11460,"Ann Arbor, MI Metro Area",Bus,2015,248,389,637,0,
181,11460,"Ann Arbor, MI Metro Area",Bus,2016,171,297,468,0,
183,11460,"Ann Arbor, MI Metro Area",Bus,2017,205,341,546,0,
185,11460,"Ann Arbor, MI Metro Area",Bus,2018,174,311,485,0,
204,11540,"Appleton, WI Metro Area",Bus,2002,4,24,28,0,
206,11540,"Appleton, WI Metro Area",Bus,2003,29,101,130,0,
208,11540,"Appleton, WI Metro Area",Bus,2004,35,129,164,0,
210,11540,"Appleton, WI Metro Area",Bus,2005,33,101,134,0,
212,11540,"Appleton, WI Metro Area",Bus,2006,21,48,69,0,
214,11540,"Appleton, WI Metro Area",Bus,2007,29,78,107,0,
216,11540,"Appleton, WI Metro Area",Bus,2008,39,106,145,0,
218,11540,"Appleton, WI Metro Area",Bus,2009,33,81,114,0,
220,11540,"Appleton, WI Metro Area",Bus,2010,36,158,194,0,
222,11540,"Appleton, WI Metro Area",Bus,2011,33,162,195,0,
224,11540,"Appleton, WI Metro Area",Bus,2012,29,149,178,0,
226,11540,"Appleton, WI Metro Area",Bus,2013,26,148,174,0,
228,11540,"Appleton, WI Metro Area",Bus,2014,44,155,199,0,
230,11540,"Appleton, WI Metro Area",Bus,2015,29,93,122,0,
232,11540,"Appleton, WI Metro Area",Bus,2016,38,127,165,0,
234,11540,"Appleton, WI Metro Area",Bus,2017,44,138,182,0,
236,11540,"Appleton, WI Metro Area",Bus,2018,35,157,192,0,
238,11700,"Asheville, NC Metro Area",Bus,2002,11,38,49,0,
239,11700,"Asheville, NC Metro Area",Bus,2003,2,57,59,0,
240,11700,"Asheville, NC Metro Area",Bus,2004,3,70,73,0,
241,11700,"Asheville, NC Metro Area",Bus,2005,8,100,108,0,
242,11700,"Asheville, NC Metro Area",Bus,2006,6,96,102,0,
243,11700,"Asheville, NC Metro Area",Bus,2007,18,105,123,0,
244,11700,"Asheville, NC Metro Area",Bus,2008,38,71,109,0,
245,11700,"Asheville, NC Metro Area",Bus,2009,44,284,328,0,
246,11700,"Asheville, NC Metro Area",Bus,2010,82,527,609,0,
247,11700,"Asheville, NC Metro Area",Bus,2011,76,490,566,0,
248,11700,"Asheville, NC Metro Area",Bus,2012,63,460,523,0,
249,11700,"Asheville, NC Metro Area",Bus,2013,57,413,470,0,
250,11700,"Asheville, NC Metro Area",Bus,2014,59,428,487,0,
251,11700,"Asheville, NC Metro Area",Bus,2015,26,349,375,0,
252,11700,"Asheville, NC Metro Area",Bus,2016,22,347,369,0,
253,11700,"Asheville, NC Metro Area",Bus,2017,9,255,264,0,
254,11700,"Asheville, NC Metro Area",Bus,2018,10,366,376,0,
255,12020,"Athens-Clarke County, GA Metro Area",Bus,2002,51,21,72,0,
256,12020,"Athens-Clarke County, GA Metro Area",Bus,2003,67,87,154,0,
257,12020,"Athens-Clarke County, GA Metro Area",Bus,2004,102,3,105,0,
258,12020,"Athens-Clarke County, GA Metro Area",Bus,2005,110,84,194,0,
259,12020,"Athens-Clarke County, GA Metro Area",Bus,2006,25,108,133,0,
260,12020,"Athens-Clarke County, GA Metro Area",Bus,2007,20,103,123,0,
261,12020,"Athens-Clarke County, GA Metro Area",Bus,2008,23,136,159,0,
262,12020,"Athens-Clarke County, GA Metro Area",Bus,2009,42,625,667,0,
263,12020,"Athens-Clarke County, GA Metro Area",Bus,2010,55,629,684,0,
264,12020,"Athens-Clarke County, GA Metro Area",Bus,2011,36,639,675,0,
265,12020,"Athens-Clarke County, GA Metro Area",Bus,2012,53,619,672,0,
266,12020,"Athens-Clarke County, GA Metro Area",Bus,2013,28,598,626,0,
267,12020,"Athens-Clarke County, GA Metro Area",Bus,2014,26,564,590,0,
268,12020,"Athens-Clarke County, GA Metro Area",Bus,2015,36,588,624,0,
269,12020,"Athens-Clarke County, GA Metro Area",Bus,2016,35,282,317,0,
270,12020,"Athens-Clarke County, GA Metro Area",Bus,2017,106,221,327,0,
271,12020,"Athens-Clarke County, GA Metro Area",Bus,2018,105,259,364,0,
272,12060,"Atlanta-Sandy Springs-Marietta, GA Metro Area",Bus,2002,10544,504,11048,0,
273,12060,"Atlanta-Sandy Springs-Marietta, GA Metro Area",Bus,2003,10030,519,10549,0,
274,12060,"Atlanta-Sandy Springs-Marietta, GA Metro Area",Bus,2004,8215,570,8785,0,
275,12060,"Atlanta-Sandy Springs-Marietta, GA Metro Area",Bus,2005,5755,1181,6936,0,
276,12060,"Atlanta-Sandy Springs-Marietta, GA Metro Area",Bus,2006,5846,1299,7145,0,
277,12060,"Atlanta-Sandy Springs-Marietta, GA Metro Area",Bus,2007,8304,2200,10504,0,
278,12060,"Atlanta-Sandy Springs-Marietta, GA Metro Area",Bus,2008,9364,1834,11198,0,
279,12060,"Atlanta-Sandy Springs-Marietta, GA Metro Area",Bus,2009,10991,2705,13696,0,
280,12060,"Atlanta-Sandy Springs-Marietta, GA Metro Area",Bus,2010,9605,2365,11970,0,
281,12060,"Atlanta-Sandy Springs-Marietta, GA Metro Area",Bus,2011,6174,2654,8828,0,
282,12060,"Atlanta-Sandy Springs-Marietta, GA Metro Area",Bus,2012,5929,2877,8806,0,
283,12060,"Atlanta-Sandy Springs-Marietta, GA Metro Area",Bus,2013,6634,2969,9603,0,
284,12060,"Atlanta-Sandy Springs-Marietta, GA Metro Area",Bus,2014,7232,2427,9659,0,
285,12060,"Atlanta-Sandy Springs-Marietta, GA Metro Area",Bus,2015,4882,1714,6596,0,
286,12060,"Atlanta-Sandy Springs-Marietta, GA Metro Area",Bus,2016,4460,1620,6080,0,
287,12060,"Atlanta-Sandy Springs-Marietta, GA Metro Area",Bus,2017,7010,2017,9027,0,
288,12060,"Atlanta-Sandy Springs-Marietta, GA Metro Area",Bus,2018,8177,3339,11516,0,
289,12060,"Atlanta-Sandy Springs-Marietta, GA Metro Area",Rail,2002,1130,392,1522,0,
290,12060,"Atlanta-Sandy Springs-Marietta, GA Metro Area",Rail,2003,1107,364,1471,0,
291,12060,"Atlanta-Sandy Springs-Marietta, GA Metro Area",Rail,2004,10072,892,10964,1,Wacky
292,12060,"Atlanta-Sandy Springs-Marietta, GA Metro Area",Rail,2005,13476,1278,14754,1,Wacky
293,12060,"Atlanta-Sandy Springs-Marietta, GA Metro Area",Rail,2006,13425,1150,14575,1,Wacky
294,12060,"Atlanta-Sandy Springs-Marietta, GA Metro Area",Rail,2007,1964,98,2062,0,
295,12060,"Atlanta-Sandy Springs-Marietta, GA Metro Area",Rail,2008,1966,97,2063,0,
296,12060,"Atlanta-Sandy Springs-Marietta, GA Metro Area",Rail,2009,1222,60,1282,0,
297,12060,"Atlanta-Sandy Springs-Marietta, GA Metro Area",Rail,2010,919,74,993,0,
298,12060,"Atlanta-Sandy Springs-Marietta, GA Metro Area",Rail,2011,422,160,582,0,
299,12060,"Atlanta-Sandy Springs-Marietta, GA Metro Area",Rail,2012,736,182,918,0,
300,12060,"Atlanta-Sandy Springs-Marietta, GA Metro Area",Rail,2013,768,146,914,0,
301,12060,"Atlanta-Sandy Springs-Marietta, GA Metro Area",Rail,2014,822,160,982,0,
302,12060,"Atlanta-Sandy Springs-Marietta, GA Metro Area",Rail,2015,743,232,975,0,
303,12060,"Atlanta-Sandy Springs-Marietta, GA Metro Area",Rail,2016,797,250,1047,0,
304,12060,"Atlanta-Sandy Springs-Marietta, GA Metro Area",Rail,2017,788,168,956,0,
305,12060,"Atlanta-Sandy Springs-Marietta, GA Metro Area",Rail,2018,798,179,977,0,
306,12260,"Augusta-Richmond County, GA-SC Metro Area",Bus,2002,89,110,199,0,
307,12260,"Augusta-Richmond County, GA-SC Metro Area",Bus,2003,94,138,232,0,
308,12260,"Augusta-Richmond County, GA-SC Metro Area",Bus,2004,119,112,231,0,
309,12260,"Augusta-Richmond County, GA-SC Metro Area",Bus,2005,130,78,208,0,
310,12260,"Augusta-Richmond County, GA-SC Metro Area",Bus,2006,123,76,199,0,
311,12260,"Augusta-Richmond County, GA-SC Metro Area",Bus,2007,95,132,227,0,
312,12260,"Augusta-Richmond County, GA-SC Metro Area",Bus,2008,84,169,253,0,
313,12260,"Augusta-Richmond County, GA-SC Metro Area",Bus,2009,81,162,243,0,
314,12260,"Augusta-Richmond County, GA-SC Metro Area",Bus,2010,152,108,260,0,
315,12260,"Augusta-Richmond County, GA-SC Metro Area",Bus,2011,88,132,220,0,
316,12260,"Augusta-Richmond County, GA-SC Metro Area",Bus,2012,92,127,219,0,
317,12260,"Augusta-Richmond County, GA-SC Metro Area",Bus,2013,117,124,241,0,
318,12260,"Augusta-Richmond County, GA-SC Metro Area",Bus,2014,288,118,406,0,
319,12260,"Augusta-Richmond County, GA-SC Metro Area",Bus,2015,103,183,286,0,
320,12260,"Augusta-Richmond County, GA-SC Metro Area",Bus,2016,268,124,392,0,
321,12260,"Augusta-Richmond County, GA-SC Metro Area",Bus,2017,305,143,448,0,
322,12260,"Augusta-Richmond County, GA-SC Metro Area",Bus,2018,202,143,345,0,
323,12420,"Austin-Round Rock-San Marcos, TX Metro Area",Bus,2002,1377,243,1620,0,
324,12420,"Austin-Round Rock-San Marcos, TX Metro Area",Bus,2003,2085,424,2509,0,
325,12420,"Austin-Round Rock-San Marcos, TX Metro Area",Bus,2004,4704,305,5009,0,
326,12420,"Austin-Round Rock-San Marcos, TX Metro Area",Bus,2005,3210,173,3383,0,
327,12420,"Austin-Round Rock-San Marcos, TX Metro Area",Bus,2006,2475,203,2678,0,
328,12420,"Austin-Round Rock-San Marcos, TX Metro Area",Bus,2007,1699,110,1809,0,
329,12420,"Austin-Round Rock-San Marcos, TX Metro Area",Bus,2008,1884,128,2012,0,
330,12420,"Austin-Round Rock-San Marcos, TX Metro Area",Bus,2009,2355,625,2980,0,
331,12420,"Austin-Round Rock-San Marcos, TX Metro Area",Bus,2010,2875,905,3780,0,
332,12420,"Austin-Round Rock-San Marcos, TX Metro Area",Bus,2011,2899,962,3861,0,
333,12420,"Austin-Round Rock-San Marcos, TX Metro Area",Bus,2012,3011,1201,4212,0,
334,12420,"Austin-Round Rock-San Marcos, TX Metro Area",Bus,2013,2229,1549,3778,0,
335,12420,"Austin-Round Rock-San Marcos, TX Metro Area",Bus,2014,512,234,746,1,Under-reported
336,12420,"Austin-Round Rock-San Marcos, TX Metro Area",Bus,2015,5001,440,5441,0,
337,12420,"Austin-Round Rock-San Marcos, TX Metro Area",Bus,2016,4177,932,5109,0,
338,12420,"Austin-Round Rock-San Marcos, TX Metro Area",Bus,2017,3081,514,3595,0,
339,12420,"Austin-Round Rock-San Marcos, TX Metro Area",Bus,2018,3469,501,3970,0,
340,12420,"Austin-Round Rock-San Marcos, TX Metro Area",Rail,2002,0,0,0,1,Not reported
341,12420,"Austin-Round Rock-San Marcos, TX Metro Area",Rail,2003,0,0,0,1,Not reported
342,12420,"Austin-Round Rock-San Marcos, TX Metro Area",Rail,2004,0,0,0,1,Not reported
343,12420,"Austin-Round Rock-San Marcos, TX Metro Area",Rail,2005,0,0,0,1,Not reported
344,12420,"Austin-Round Rock-San Marcos, TX Metro Area",Rail,2006,0,0,0,1,Not reported
345,12420,"Austin-Round Rock-San Marcos, TX Metro Area",Rail,2007,0,0,0,1,Not reported
346,12420,"Austin-Round Rock-San Marcos, TX Metro Area",Rail,2008,0,0,0,1,Not reported
347,12420,"Austin-Round Rock-San Marcos, TX Metro Area",Rail,2009,0,0,0,1,Not reported
348,12420,"Austin-Round Rock-San Marcos, TX Metro Area",Rail,2010,0,0,0,1,Not reported
349,12420,"Austin-Round Rock-San Marcos, TX Metro Area",Rail,2011,6,1,7,0,
350,12420,"Austin-Round Rock-San Marcos, TX Metro Area",Rail,2012,6,6,12,0,
351,12420,"Austin-Round Rock-San Marcos, TX Metro Area",Rail,2013,7,7,14,0,
352,12420,"Austin-Round Rock-San Marcos, TX Metro Area",Rail,2014,4,16,20,0,
353,12420,"Austin-Round Rock-San Marcos, TX Metro Area",Rail,2015,15,16,31,0,
354,12420,"Austin-Round Rock-San Marcos, TX Metro Area",Rail,2016,3,0,3,0,
355,12420,"Austin-Round Rock-San Marcos, TX Metro Area",Rail,2017,4,0,4,0,
356,12420,"Austin-Round Rock-San Marcos, TX Metro Area",Rail,2018,6,0,6,0,
357,12540,"Bakersfield-Delano, CA Metro Area",Bus,2002,468,325,793,0,
358,12540,"Bakersfield-Delano, CA Metro Area",Bus,2003,571,335,906,0,
359,12540,"Bakersfield-Delano, CA Metro Area",Bus,2004,448,457,905,0,
360,12540,"Bakersfield-Delano, CA Metro Area",Bus,2005,417,440,857,0,
361,12540,"Bakersfield-Delano, CA Metro Area",Bus,2006,427,344,771,0,
362,12540,"Bakersfield-Delano, CA Metro Area",Bus,2007,330,299,629,0,
363,12540,"Bakersfield-Delano, CA Metro Area",Bus,2008,295,329,624,0,
364,12540,"Bakersfield-Delano, CA Metro Area",Bus,2009,378,288,666,0,
365,12540,"Bakersfield-Delano, CA Metro Area",Bus,2010,428,311,739,0,
366,12540,"Bakersfield-Delano, CA Metro Area",Bus,2011,370,277,647,0,
367,12540,"Bakersfield-Delano, CA Metro Area",Bus,2012,276,188,464,0,
368,12540,"Bakersfield-Delano, CA Metro Area",Bus,2013,250,179,429,0,
369,12540,"Bakersfield-Delano, CA Metro Area",Bus,2014,320,212,532,0,
370,12540,"Bakersfield-Delano, CA Metro Area",Bus,2015,253,168,421,0,
371,12540,"Bakersfield-Delano, CA Metro Area",Bus,2016,331,85,416,0,
372,12540,"Bakersfield-Delano, CA Metro Area",Bus,2017,331,193,524,0,
373,12540,"Bakersfield-Delano, CA Metro Area",Bus,2018,461,184,645,0,
374,12580,"Baltimore-Towson, MD Metro Area",Bus,2002,3792,0,3792,0,
375,12580,"Baltimore-Towson, MD Metro Area",Bus,2003,4424,0,4424,1,Other not reported
376,12580,"Baltimore-Towson, MD Metro Area",Bus,2004,3284,0,3284,1,Other not reported
377,12580,"Baltimore-Towson, MD Metro Area",Bus,2005,4257,0,4257,1,Other not reported
378,12580,"Baltimore-Towson, MD Metro Area",Bus,2006,3504,0,3504,1,Other not reported
379,12580,"Baltimore-Towson, MD Metro Area",Bus,2007,3299,0,3299,1,Other not reported
380,12580,"Baltimore-Towson, MD Metro Area",Bus,2008,3855,0,3855,1,Other not reported
381,12580,"Baltimore-Towson, MD Metro Area",Bus,2009,4788,0,4788,1,Other not reported
382,12580,"Baltimore-Towson, MD Metro Area",Bus,2010,3768,0,3768,1,Other not reported
383,12580,"Baltimore-Towson, MD Metro Area",Bus,2011,4514,0,4514,1,Other not reported
384,12580,"Baltimore-Towson, MD Metro Area",Bus,2012,3108,14,3122,1,Other not reported
385,12580,"Baltimore-Towson, MD Metro Area",Bus,2013,3251,10,3261,1,Other not reported
386,12580,"Baltimore-Towson, MD Metro Area",Bus,2014,3507,3753,7260,0,
387,12580,"Baltimore-Towson, MD Metro Area",Bus,2015,4600,4235,8835,0,
388,12580,"Baltimore-Towson, MD Metro Area",Bus,2016,4316,4093,8409,0,
389,12580,"Baltimore-Towson, MD Metro Area",Bus,2017,4402,4656,9058,0,
390,12580,"Baltimore-Towson, MD Metro Area",Bus,2018,4040,4529,8569,0,
391,12580,"Baltimore-Towson, MD Metro Area",Rail,2002,451,0,451,1,Other not reported
392,12580,"Baltimore-Towson, MD Metro Area",Rail,2003,446,0,446,1,Other not reported
393,12580,"Baltimore-Towson, MD Metro Area",Rail,2004,400,0,400,1,Other not reported
394,12580,"Baltimore-Towson, MD Metro Area",Rail,2005,322,0,322,1,Other not reported
395,12580,"Baltimore-Towson, MD Metro Area",Rail,2006,352,0,352,1,Other not reported
396,12580,"Baltimore-Towson, MD Metro Area",Rail,2007,567,0,567,1,Other not reported
397,12580,"Baltimore-Towson, MD Metro Area",Rail,2008,605,0,605,1,Other not reported
398,12580,"Baltimore-Towson, MD Metro Area",Rail,2009,890,0,890,1,Other not reported
399,12580,"Baltimore-Towson, MD Metro Area",Rail,2010,932,0,932,1,Other not reported
400,12580,"Baltimore-Towson, MD Metro Area",Rail,2011,1176,97,1273,1,Other not reported
401,12580,"Baltimore-Towson, MD Metro Area",Rail,2012,864,0,864,1,Other not reported
402,12580,"Baltimore-Towson, MD Metro Area",Rail,2013,445,0,445,1,Other not reported
403,12580,"Baltimore-Towson, MD Metro Area",Rail,2014,483,0,483,1,Other not reported
404,12580,"Baltimore-Towson, MD Metro Area",Rail,2015,790,3293,4083,0,
405,12580,"Baltimore-Towson, MD Metro Area",Rail,2016,1248,3125,4373,0,
406,12580,"Baltimore-Towson, MD Metro Area",Rail,2017,1459,1382,2841,0,
407,12580,"Baltimore-Towson, MD Metro Area",Rail,2018,1344,1554,2898,0,
408,12940,"Baton Rouge, LA Metro Area",Bus,2002,261,60,321,0,
409,12940,"Baton Rouge, LA Metro Area",Bus,2003,236,86,322,0,
410,12940,"Baton Rouge, LA Metro Area",Bus,2004,546,583,1129,0,
411,12940,"Baton Rouge, LA Metro Area",Bus,2005,163,430,593,0,
412,12940,"Baton Rouge, LA Metro Area",Bus,2006,144,508,652,0,
413,12940,"Baton Rouge, LA Metro Area",Bus,2007,287,320,607,0,
414,12940,"Baton Rouge, LA Metro Area",Bus,2008,308,185,493,0,
415,12940,"Baton Rouge, LA Metro Area",Bus,2009,178,150,328,0,
416,12940,"Baton Rouge, LA Metro Area",Bus,2010,291,183,474,0,
417,12940,"Baton Rouge, LA Metro Area",Bus,2011,250,191,441,0,
418,12940,"Baton Rouge, LA Metro Area",Bus,2012,300,176,476,0,
419,12940,"Baton Rouge, LA Metro Area",Bus,2013,356,147,503,0,
420,12940,"Baton Rouge, LA Metro Area",Bus,2014,547,212,759,0,
421,12940,"Baton Rouge, LA Metro Area",Bus,2015,786,275,1061,0,
422,12940,"Baton Rouge, LA Metro Area",Bus,2016,622,255,877,0,
423,12940,"Baton Rouge, LA Metro Area",Bus,2017,348,206,554,0,
424,12940,"Baton Rouge, LA Metro Area",Bus,2018,369,190,559,0,
425,13020,"Bay City, MI Metro Area",Bus,2002,3,72,75,0,
426,13020,"Bay City, MI Metro Area",Bus,2003,2,50,52,0,
427,13020,"Bay City, MI Metro Area",Bus,2004,2,82,84,0,
428,13020,"Bay City, MI Metro Area",Bus,2005,7,87,94,0,
429,13020,"Bay City, MI Metro Area",Bus,2006,5,75,80,0,
430,13020,"Bay City, MI Metro Area",Bus,2007,1,52,53,0,
431,13020,"Bay City, MI Metro Area",Bus,2008,5,55,60,0,
432,13020,"Bay City, MI Metro Area",Bus,2009,31,40,71,0,
433,13020,"Bay City, MI Metro Area",Bus,2010,41,19,60,0,
434,13020,"Bay City, MI Metro Area",Bus,2011,50,19,69,0,
435,13020,"Bay City, MI Metro Area",Bus,2012,35,23,58,0,
436,13020,"Bay City, MI Metro Area",Bus,2013,23,26,49,0,
437,13020,"Bay City, MI Metro Area",Bus,2014,25,24,49,0,
438,13020,"Bay City, MI Metro Area",Bus,2015,23,20,43,0,
439,13020,"Bay City, MI Metro Area",Bus,2016,24,13,37,0,
440,13020,"Bay City, MI Metro Area",Bus,2017,15,17,32,0,
441,13020,"Bay City, MI Metro Area",Bus,2018,20,35,55,0,
442,13140,"Beaumont-Port Arthur, TX Metro Area",Bus,2002,47,22,69,0,
443,13140,"Beaumont-Port Arthur, TX Metro Area",Bus,2003,52,21,73,0,
444,13140,"Beaumont-Port Arthur, TX Metro Area",Bus,2004,46,17,63,0,
445,13140,"Beaumont-Port Arthur, TX Metro Area",Bus,2005,41,15,56,0,
446,13140,"Beaumont-Port Arthur, TX Metro Area",Bus,2006,44,13,57,0,
447,13140,"Beaumont-Port Arthur, TX Metro Area",Bus,2007,48,14,62,0,
448,13140,"Beaumont-Port Arthur, TX Metro Area",Bus,2008,45,13,58,0,
449,13140,"Beaumont-Port Arthur, TX Metro Area",Bus,2009,57,14,71,0,
450,13140,"Beaumont-Port Arthur, TX Metro Area",Bus,2010,32,8,40,0,
451,13140,"Beaumont-Port Arthur, TX Metro Area",Bus,2011,26,6,32,0,
452,13140,"Beaumont-Port Arthur, TX Metro Area",Bus,2012,28,8,36,0,
453,13140,"Beaumont-Port Arthur, TX Metro Area",Bus,2013,30,9,39,0,
454,13140,"Beaumont-Port Arthur, TX Metro Area",Bus,2014,36,12,48,0,
455,13140,"Beaumont-Port Arthur, TX Metro Area",Bus,2015,42,8,50,0,
456,13140,"Beaumont-Port Arthur, TX Metro Area",Bus,2016,5,15,20,0,
457,13140,"Beaumont-Port Arthur, TX Metro Area",Bus,2017,6,18,24,0,
458,13140,"Beaumont-Port Arthur, TX Metro Area",Bus,2018,7,19,26,0,
459,13380,"Bellingham, WA Metro Area",Bus,2002,135,133,268,0,
460,13380,"Bellingham, WA Metro Area",Bus,2003,58,176,234,0,
461,13380,"Bellingham, WA Metro Area",Bus,2004,62,292,354,0,
462,13380,"Bellingham, WA Metro Area",Bus,2005,41,254,295,0,
463,13380,"Bellingham, WA Metro Area",Bus,2006,28,214,242,0,
464,13380,"Bellingham, WA Metro Area",Bus,2007,57,48,105,0,
465,13380,"Bellingham, WA Metro Area",Bus,2008,144,9,153,0,
466,13380,"Bellingham, WA Metro Area",Bus,2009,94,43,137,0,
467,13380,"Bellingham, WA Metro Area",Bus,2010,64,41,105,0,
468,13380,"Bellingham, WA Metro Area",Bus,2011,70,32,102,0,
469,13380,"Bellingham, WA Metro Area",Bus,2012,87,28,115,0,
470,13380,"Bellingham, WA Metro Area",Bus,2013,133,72,205,0,
471,13380,"Bellingham, WA Metro Area",Bus,2014,175,55,230,0,
472,13380,"Bellingham, WA Metro Area",Bus,2015,156,48,204,0,
473,13380,"Bellingham, WA Metro Area",Bus,2016,124,51,175,0,
474,13380,"Bellingham, WA Metro Area",Bus,2017,146,12,158,0,
475,13380,"Bellingham, WA Metro Area",Bus,2018,127,16,143,0,
476,13740,"Billings, MT Metro Area",Bus,2002,23,9,32,0,
477,13740,"Billings, MT Metro Area",Bus,2003,27,12,39,0,
478,13740,"Billings, MT Metro Area",Bus,2004,25,9,34,0,
479,13740,"Billings, MT Metro Area",Bus,2005,21,7,28,0,
480,13740,"Billings, MT Metro Area",Bus,2006,19,4,23,0,
481,13740,"Billings, MT Metro Area",Bus,2007,20,6,26,0,
482,13740,"Billings, MT Metro Area",Bus,2008,37,95,132,0,
483,13740,"Billings, MT Metro Area",Bus,2009,54,78,132,0,
484,13740,"Billings, MT Metro Area",Bus,2010,56,86,142,0,
485,13740,"Billings, MT Metro Area",Bus,2011,52,96,148,0,
486,13740,"Billings, MT Metro Area",Bus,2012,61,134,195,0,
487,13740,"Billings, MT Metro Area",Bus,2013,73,158,231,0,
488,13740,"Billings, MT Metro Area",Bus,2014,73,158,231,0,
489,13740,"Billings, MT Metro Area",Bus,2015,216,274,490,0,
490,13740,"Billings, MT Metro Area",Bus,2016,248,283,531,0,
491,13740,"Billings, MT Metro Area",Bus,2017,198,347,545,0,
492,13740,"Billings, MT Metro Area",Bus,2018,303,205,508,0,
493,13780,"Binghamton, NY Metro Area",Bus,2002,227,970,1197,0,
494,13780,"Binghamton, NY Metro Area",Bus,2003,294,917,1211,0,
495,13780,"Binghamton, NY Metro Area",Bus,2004,213,602,815,0,
496,13780,"Binghamton, NY Metro Area",Bus,2005,300,550,850,0,
497,13780,"Binghamton, NY Metro Area",Bus,2006,183,499,682,0,
498,13780,"Binghamton, NY Metro Area",Bus,2007,208,550,758,0,
499,13780,"Binghamton, NY Metro Area",Bus,2008,221,544,765,0,
500,13780,"Binghamton, NY Metro Area",Bus,2009,271,629,900,0,
501,13780,"Binghamton, NY Metro Area",Bus,2010,235,655,890,0,
502,13780,"Binghamton, NY Metro Area",Bus,2011,169,538,707,0,
503,13780,"Binghamton, NY Metro Area",Bus,2012,111,485,596,0,
504,13780,"Binghamton, NY Metro Area",Bus,2013,134,494,628,0,
505,13780,"Binghamton, NY Metro Area",Bus,2014,155,494,649,0,
506,13780,"Binghamton, NY Metro Area",Bus,2015,210,384,594,0,
507,13780,"Binghamton, NY Metro Area",Bus,2016,193,557,750,0,
508,13780,"Binghamton, NY Metro Area",Bus,2017,208,484,692,0,
509,13780,"Binghamton, NY Metro Area",Bus,2018,174,454,628,0,
510,13820,"Birmingham-Hoover, AL Metro Area",Bus,2002,0,0,0,1,Not reported
511,13820,"Birmingham-Hoover, AL Metro Area",Bus,2003,0,0,0,1,Not reported
512,13820,"Birmingham-Hoover, AL Metro Area",Bus,2004,1401,999,2400,0,
513,13820,"Birmingham-Hoover, AL Metro Area",Bus,2005,840,574,1414,0,
514,13820,"Birmingham-Hoover, AL Metro Area",Bus,2006,1141,607,1748,0,
515,13820,"Birmingham-Hoover, AL Metro Area",Bus,2007,1246,668,1914,0,
516,13820,"Birmingham-Hoover, AL Metro Area",Bus,2008,1069,710,1779,0,
517,13820,"Birmingham-Hoover, AL Metro Area",Bus,2009,1078,708,1786,0,
518,13820,"Birmingham-Hoover, AL Metro Area",Bus,2010,1021,652,1673,0,
519,13820,"Birmingham-Hoover, AL Metro Area",Bus,2011,876,635,1511,0,
520,13820,"Birmingham-Hoover, AL Metro Area",Bus,2012,788,572,1360,0,
521,13820,"Birmingham-Hoover, AL Metro Area",Bus,2013,967,690,1657,0,
522,13820,"Birmingham-Hoover, AL Metro Area",Bus,2014,391,471,862,0,
523,13820,"Birmingham-Hoover, AL Metro Area",Bus,2015,576,792,1368,0,
524,13820,"Birmingham-Hoover, AL Metro Area",Bus,2016,1136,950,2086,0,
525,13820,"Birmingham-Hoover, AL Metro Area",Bus,2017,749,608,1357,0,
526,13820,"Birmingham-Hoover, AL Metro Area",Bus,2018,350,257,607,0,
527,13980,"Blacksburg-Christiansburg-Radford, VA Metro Area",Bus,2002,0,0,0,1,Not reported
528,13980,"Blacksburg-Christiansburg-Radford, VA Metro Area",Bus,2003,0,0,0,1,Not reported
529,13980,"Blacksburg-Christiansburg-Radford, VA Metro Area",Bus,2004,0,0,0,1,Not reported
530,13980,"Blacksburg-Christiansburg-Radford, VA Metro Area",Bus,2005,3,17,20,1,Under-reported
531,13980,"Blacksburg-Christiansburg-Radford, VA Metro Area",Bus,2006,10,4,14,1,Under-reported
532,13980,"Blacksburg-Christiansburg-Radford, VA Metro Area",Bus,2007,8,25,33,1,Under-reported
533,13980,"Blacksburg-Christiansburg-Radford, VA Metro Area",Bus,2008,13,18,31,1,Under-reported
534,13980,"Blacksburg-Christiansburg-Radford, VA Metro Area",Bus,2009,94,146,240,0,
535,13980,"Blacksburg-Christiansburg-Radford, VA Metro Area",Bus,2010,131,116,247,0,
536,13980,"Blacksburg-Christiansburg-Radford, VA Metro Area",Bus,2011,188,91,279,0,
537,13980,"Blacksburg-Christiansburg-Radford, VA Metro Area",Bus,2012,127,153,280,0,
538,13980,"Blacksburg-Christiansburg-Radford, VA Metro Area",Bus,2013,205,38,243,0,
539,13980,"Blacksburg-Christiansburg-Radford, VA Metro Area",Bus,2014,168,53,221,0,
540,13980,"Blacksburg-Christiansburg-Radford, VA Metro Area",Bus,2015,120,82,202,0,
541,13980,"Blacksburg-Christiansburg-Radford, VA Metro Area",Bus,2016,136,76,212,0,
542,13980,"Blacksburg-Christiansburg-Radford, VA Metro Area",Bus,2017,155,118,273,0,
543,13980,"Blacksburg-Christiansburg-Radford, VA Metro Area",Bus,2018,173,139,312,0,
544,14020,"Bloomington, IN Metro Area",Bus,2002,102,0,102,1,Other not reported
545,14020,"Bloomington, IN Metro Area",Bus,2003,123,210,333,0,
546,14020,"Bloomington, IN Metro Area",Bus,2004,116,190,306,0,
547,14020,"Bloomington, IN Metro Area",Bus,2005,171,160,331,0,
548,14020,"Bloomington, IN Metro Area",Bus,2006,124,134,258,0,
549,14020,"Bloomington, IN Metro Area",Bus,2007,105,78,183,0,
550,14020,"Bloomington, IN Metro Area",Bus,2008,125,96,221,0,
551,14020,"Bloomington, IN Metro Area",Bus,2009,153,93,246,0,
552,14020,"Bloomington, IN Metro Area",Bus,2010,181,119,300,0,
553,14020,"Bloomington, IN Metro Area",Bus,2011,184,126,310,0,
554,14020,"Bloomington, IN Metro Area",Bus,2012,204,151,355,0,
555,14020,"Bloomington, IN Metro Area",Bus,2013,222,88,310,0,
556,14020,"Bloomington, IN Metro Area",Bus,2014,181,94,275,0,
557,14020,"Bloomington, IN Metro Area",Bus,2015,122,102,224,0,
558,14020,"Bloomington, IN Metro Area",Bus,2016,151,125,276,0,
559,14020,"Bloomington, IN Metro Area",Bus,2017,162,93,255,0,
560,14020,"Bloomington, IN Metro Area",Bus,2018,116,40,156,0,
561,14060,"Bloomington-Normal, IL Metro Area",Bus,2002,87,372,459,0,
562,14060,"Bloomington-Normal, IL Metro Area",Bus,2003,95,437,532,0,
563,14060,"Bloomington-Normal, IL Metro Area",Bus,2004,144,557,701,0,
564,14060,"Bloomington-Normal, IL Metro Area",Bus,2005,190,277,467,0,
565,14060,"Bloomington-Normal, IL Metro Area",Bus,2006,180,391,571,0,
566,14060,"Bloomington-Normal, IL Metro Area",Bus,2007,191,258,449,0,
567,14060,"Bloomington-Normal, IL Metro Area",Bus,2008,153,303,456,0,
568,14060,"Bloomington-Normal, IL Metro Area",Bus,2009,199,259,458,0,
569,14060,"Bloomington-Normal, IL Metro Area",Bus,2010,143,240,383,0,
570,14060,"Bloomington-Normal, IL Metro Area",Bus,2011,21,229,250,0,
571,14060,"Bloomington-Normal, IL Metro Area",Bus,2012,26,226,252,0,
572,14060,"Bloomington-Normal, IL Metro Area",Bus,2013,31,187,218,0,
573,14060,"Bloomington-Normal, IL Metro Area",Bus,2014,38,208,246,0,
574,14060,"Bloomington-Normal, IL Metro Area",Bus,2015,29,273,302,0,
575,14060,"Bloomington-Normal, IL Metro Area",Bus,2016,45,300,345,0,
576,14060,"Bloomington-Normal, IL Metro Area",Bus,2017,43,399,442,0,
577,14060,"Bloomington-Normal, IL Metro Area",Bus,2018,65,355,420,0,
578,14260,"Boise City-Nampa, ID Metro Area",Bus,2002,309,292,601,0,
579,14260,"Boise City-Nampa, ID Metro Area",Bus,2003,209,130,339,0,
580,14260,"Boise City-Nampa, ID Metro Area",Bus,2004,195,58,253,0,
581,14260,"Boise City-Nampa, ID Metro Area",Bus,2005,124,131,255,0,
582,14260,"Boise City-Nampa, ID Metro Area",Bus,2006,320,104,424,0,
583,14260,"Boise City-Nampa, ID Metro Area",Bus,2007,164,124,288,0,
584,14260,"Boise City-Nampa, ID Metro Area",Bus,2008,135,277,412,0,
585,14260,"Boise City-Nampa, ID Metro Area",Bus,2009,94,40,134,0,
586,14260,"Boise City-Nampa, ID Metro Area",Bus,2010,100,73,173,0,
587,14260,"Boise City-Nampa, ID Metro Area",Bus,2011,215,29,244,0,
588,14260,"Boise City-Nampa, ID Metro Area",Bus,2012,97,38,135,0,
589,14260,"Boise City-Nampa, ID Metro Area",Bus,2013,92,22,114,0,
590,14260,"Boise City-Nampa, ID Metro Area",Bus,2014,87,16,103,0,
591,14260,"Boise City-Nampa, ID Metro Area",Bus,2015,77,32,109,0,
592,14260,"Boise City-Nampa, ID Metro Area",Bus,2016,94,15,109,0,
593,14260,"Boise City-Nampa, ID Metro Area",Bus,2017,101,26,127,0,
594,14260,"Boise City-Nampa, ID Metro Area",Bus,2018,30,59,89,0,
629,14460,"Boston-Cambridge-Quincy, MA-NH Metro Area",Bus,2002,1840,3597,5437,0,
3298,14460,"Boston-Cambridge-Quincy, MA-NH Metro Area",Bus,2002,0,0,0,0,
630,14460,"Boston-Cambridge-Quincy, MA-NH Metro Area",Bus,2003,2046,3864,5910,0,
3300,14460,"Boston-Cambridge-Quincy, MA-NH Metro Area",Bus,2003,0,0,0,0,
631,14460,"Boston-Cambridge-Quincy, MA-NH Metro Area",Bus,2004,1753,1830,3583,0,
3302,14460,"Boston-Cambridge-Quincy, MA-NH Metro Area",Bus,2004,0,0,0,0,
632,14460,"Boston-Cambridge-Quincy, MA-NH Metro Area",Bus,2005,6333,244,6577,0,
3304,14460,"Boston-Cambridge-Quincy, MA-NH Metro Area",Bus,2005,0,0,0,0,
633,14460,"Boston-Cambridge-Quincy, MA-NH Metro Area",Bus,2006,8119,326,8445,0,
3306,14460,"Boston-Cambridge-Quincy, MA-NH Metro Area",Bus,2006,0,0,0,0,
634,14460,"Boston-Cambridge-Quincy, MA-NH Metro Area",Bus,2007,4146,349,4495,0,
3308,14460,"Boston-Cambridge-Quincy, MA-NH Metro Area",Bus,2007,21,14,35,0,
635,14460,"Boston-Cambridge-Quincy, MA-NH Metro Area",Bus,2008,2577,334,2911,0,
3310,14460,"Boston-Cambridge-Quincy, MA-NH Metro Area",Bus,2008,17,16,33,0,
636,14460,"Boston-Cambridge-Quincy, MA-NH Metro Area",Bus,2009,2932,427,3359,0,
3312,14460,"Boston-Cambridge-Quincy, MA-NH Metro Area",Bus,2009,26,0,26,0,
637,14460,"Boston-Cambridge-Quincy, MA-NH Metro Area",Bus,2010,2952,429,3381,0,
3314,14460,"Boston-Cambridge-Quincy, MA-NH Metro Area",Bus,2010,21,5,26,0,
638,14460,"Boston-Cambridge-Quincy, MA-NH Metro Area",Bus,2011,2594,959,3553,0,
3316,14460,"Boston-Cambridge-Quincy, MA-NH Metro Area",Bus,2011,20,0,20,0,
639,14460,"Boston-Cambridge-Quincy, MA-NH Metro Area",Bus,2012,1929,650,2579,0,
3318,14460,"Boston-Cambridge-Quincy, MA-NH Metro Area",Bus,2012,20,0,20,0,
640,14460,"Boston-Cambridge-Quincy, MA-NH Metro Area",Bus,2013,1415,510,1925,0,
3320,14460,"Boston-Cambridge-Quincy, MA-NH Metro Area",Bus,2013,32,24,56,0,
641,14460,"Boston-Cambridge-Quincy, MA-NH Metro Area",Bus,2014,1720,408,2128,0,
3322,14460,"Boston-Cambridge-Quincy, MA-NH Metro Area",Bus,2014,51,28,79,0,
642,14460,"Boston-Cambridge-Quincy, MA-NH Metro Area",Bus,2015,1588,463,2051,0,
3324,14460,"Boston-Cambridge-Quincy, MA-NH Metro Area",Bus,2015,52,27,79,0,
643,14460,"Boston-Cambridge-Quincy, MA-NH Metro Area",Bus,2016,1365,423,1788,0,
3326,14460,"Boston-Cambridge-Quincy, MA-NH Metro Area",Bus,2016,50,26,76,0,
644,14460,"Boston-Cambridge-Quincy, MA-NH Metro Area",Bus,2017,1788,558,2346,0,
3328,14460,"Boston-Cambridge-Quincy, MA-NH Metro Area",Bus,2017,54,31,85,0,
645,14460,"Boston-Cambridge-Quincy, MA-NH Metro Area",Bus,2018,881,317,1198,0,
3330,14460,"Boston-Cambridge-Quincy, MA-NH Metro Area",Bus,2018,42,22,64,0,
646,14460,"Boston-Cambridge-Quincy, MA-NH Metro Area",Rail,2002,1962,385,2347,0,
647,14460,"Boston-Cambridge-Quincy, MA-NH Metro Area",Rail,2003,2291,924,3215,0,
648,14460,"Boston-Cambridge-Quincy, MA-NH Metro Area",Rail,2004,3134,817,3951,0,
649,14460,"Boston-Cambridge-Quincy, MA-NH Metro Area",Rail,2005,2234,1004,3238,0,
650,14460,"Boston-Cambridge-Quincy, MA-NH Metro Area",Rail,2006,1757,1185,2942,0,
651,14460,"Boston-Cambridge-Quincy, MA-NH Metro Area",Rail,2007,1639,1006,2645,0,
652,14460,"Boston-Cambridge-Quincy, MA-NH Metro Area",Rail,2008,1539,59,1598,0,
653,14460,"Boston-Cambridge-Quincy, MA-NH Metro Area",Rail,2009,2542,665,3207,0,
654,14460,"Boston-Cambridge-Quincy, MA-NH Metro Area",Rail,2010,2932,283,3215,0,
655,14460,"Boston-Cambridge-Quincy, MA-NH Metro Area",Rail,2011,2508,231,2739,0,
656,14460,"Boston-Cambridge-Quincy, MA-NH Metro Area",Rail,2012,2181,193,2374,0,
657,14460,"Boston-Cambridge-Quincy, MA-NH Metro Area",Rail,2013,1775,149,1924,0,
658,14460,"Boston-Cambridge-Quincy, MA-NH Metro Area",Rail,2014,1674,142,1816,0,
659,14460,"Boston-Cambridge-Quincy, MA-NH Metro Area",Rail,2015,2099,220,2319,0,
660,14460,"Boston-Cambridge-Quincy, MA-NH Metro Area",Rail,2016,1795,148,1943,0,
661,14460,"Boston-Cambridge-Quincy, MA-NH Metro Area",Rail,2017,1496,145,1641,0,
662,14460,"Boston-Cambridge-Quincy, MA-NH Metro Area",Rail,2018,1287,142,1429,0,
663,14740,"Bremerton-Silverdale, WA Metro Area",Bus,2002,92,53,145,0,
664,14740,"Bremerton-Silverdale, WA Metro Area",Bus,2003,114,26,140,0,
665,14740,"Bremerton-Silverdale, WA Metro Area",Bus,2004,92,32,124,0,
666,14740,"Bremerton-Silverdale, WA Metro Area",Bus,2005,129,28,157,0,
667,14740,"Bremerton-Silverdale, WA Metro Area",Bus,2006,106,41,147,0,
668,14740,"Bremerton-Silverdale, WA Metro Area",Bus,2007,139,25,164,0,
669,14740,"Bremerton-Silverdale, WA Metro Area",Bus,2008,96,20,116,0,
670,14740,"Bremerton-Silverdale, WA Metro Area",Bus,2009,90,21,111,0,
671,14740,"Bremerton-Silverdale, WA Metro Area",Bus,2010,96,30,126,0,
672,14740,"Bremerton-Silverdale, WA Metro Area",Bus,2011,109,48,157,0,
673,14740,"Bremerton-Silverdale, WA Metro Area",Bus,2012,48,34,82,0,
674,14740,"Bremerton-Silverdale, WA Metro Area",Bus,2013,140,2,142,0,
675,14740,"Bremerton-Silverdale, WA Metro Area",Bus,2014,22,57,79,0,
676,14740,"Bremerton-Silverdale, WA Metro Area",Bus,2015,123,17,140,0,
677,14740,"Bremerton-Silverdale, WA Metro Area",Bus,2016,80,14,94,0,
678,14740,"Bremerton-Silverdale, WA Metro Area",Bus,2017,20,23,43,0,
679,14740,"Bremerton-Silverdale, WA Metro Area",Bus,2018,21,28,49,0,
680,14860,"Bridgeport-Stamford-Norwalk, CT Metro Area",Bus,2002,885,729,1614,0,
1275,14860,"Bridgeport-Stamford-Norwalk, CT Metro Area",Bus,2002,31,28,59,0,
682,14860,"Bridgeport-Stamford-Norwalk, CT Metro Area",Bus,2003,939,653,1592,0,
1276,14860,"Bridgeport-Stamford-Norwalk, CT Metro Area",Bus,2003,29,42,71,0,
684,14860,"Bridgeport-Stamford-Norwalk, CT Metro Area",Bus,2004,1058,746,1804,0,
1277,14860,"Bridgeport-Stamford-Norwalk, CT Metro Area",Bus,2004,39,41,80,0,
686,14860,"Bridgeport-Stamford-Norwalk, CT Metro Area",Bus,2005,1251,1009,2260,0,
1278,14860,"Bridgeport-Stamford-Norwalk, CT Metro Area",Bus,2005,40,35,75,0,
688,14860,"Bridgeport-Stamford-Norwalk, CT Metro Area",Bus,2006,1176,777,1953,0,
1279,14860,"Bridgeport-Stamford-Norwalk, CT Metro Area",Bus,2006,30,50,80,0,
690,14860,"Bridgeport-Stamford-Norwalk, CT Metro Area",Bus,2007,1154,711,1865,0,
1280,14860,"Bridgeport-Stamford-Norwalk, CT Metro Area",Bus,2007,12,22,34,0,
692,14860,"Bridgeport-Stamford-Norwalk, CT Metro Area",Bus,2008,1311,859,2170,0,
1281,14860,"Bridgeport-Stamford-Norwalk, CT Metro Area",Bus,2008,44,18,62,0,
694,14860,"Bridgeport-Stamford-Norwalk, CT Metro Area",Bus,2009,1572,680,2252,0,
1282,14860,"Bridgeport-Stamford-Norwalk, CT Metro Area",Bus,2009,19,36,55,0,
696,14860,"Bridgeport-Stamford-Norwalk, CT Metro Area",Bus,2010,1524,660,2184,0,
1283,14860,"Bridgeport-Stamford-Norwalk, CT Metro Area",Bus,2010,14,27,41,0,
698,14860,"Bridgeport-Stamford-Norwalk, CT Metro Area",Bus,2011,1239,652,1891,0,
1284,14860,"Bridgeport-Stamford-Norwalk, CT Metro Area",Bus,2011,24,26,50,0,
700,14860,"Bridgeport-Stamford-Norwalk, CT Metro Area",Bus,2012,1100,668,1768,0,
1285,14860,"Bridgeport-Stamford-Norwalk, CT Metro Area",Bus,2012,28,33,61,0,
702,14860,"Bridgeport-Stamford-Norwalk, CT Metro Area",Bus,2013,754,819,1573,0,
1286,14860,"Bridgeport-Stamford-Norwalk, CT Metro Area",Bus,2013,21,28,49,0,
704,14860,"Bridgeport-Stamford-Norwalk, CT Metro Area",Bus,2014,659,831,1490,0,
1287,14860,"Bridgeport-Stamford-Norwalk, CT Metro Area",Bus,2014,19,26,45,0,
706,14860,"Bridgeport-Stamford-Norwalk, CT Metro Area",Bus,2015,599,696,1295,0,
1288,14860,"Bridgeport-Stamford-Norwalk, CT Metro Area",Bus,2015,19,25,44,0,
708,14860,"Bridgeport-Stamford-Norwalk, CT Metro Area",Bus,2016,641,774,1415,0,
1289,14860,"Bridgeport-Stamford-Norwalk, CT Metro Area",Bus,2016,14,20,34,0,
710,14860,"Bridgeport-Stamford-Norwalk, CT Metro Area",Bus,2017,616,1016,1632,0,
1290,14860,"Bridgeport-Stamford-Norwalk, CT Metro Area",Bus,2017,20,21,41,0,
712,14860,"Bridgeport-Stamford-Norwalk, CT Metro Area",Bus,2018,352,1057,1409,0,
1291,14860,"Bridgeport-Stamford-Norwalk, CT Metro Area",Bus,2018,12,28,40,0,
714,15180,"Brownsville-Harlingen, TX Metro Area",Bus,2002,200,361,561,0,
715,15180,"Brownsville-Harlingen, TX Metro Area",Bus,2003,101,406,507,0,
716,15180,"Brownsville-Harlingen, TX Metro Area",Bus,2004,86,342,428,0,
717,15180,"Brownsville-Harlingen, TX Metro Area",Bus,2005,52,220,272,0,
718,15180,"Brownsville-Harlingen, TX Metro Area",Bus,2006,38,160,198,0,
719,15180,"Brownsville-Harlingen, TX Metro Area",Bus,2007,413,97,510,0,
720,15180,"Brownsville-Harlingen, TX Metro Area",Bus,2008,772,267,1039,0,
721,15180,"Brownsville-Harlingen, TX Metro Area",Bus,2009,995,250,1245,0,
722,15180,"Brownsville-Harlingen, TX Metro Area",Bus,2010,1053,188,1241,0,
723,15180,"Brownsville-Harlingen, TX Metro Area",Bus,2011,157,185,342,0,
724,15180,"Brownsville-Harlingen, TX Metro Area",Bus,2012,187,358,545,0,
725,15180,"Brownsville-Harlingen, TX Metro Area",Bus,2013,301,427,728,0,
726,15180,"Brownsville-Harlingen, TX Metro Area",Bus,2014,979,1517,2496,0,
727,15180,"Brownsville-Harlingen, TX Metro Area",Bus,2015,871,562,1433,0,
728,15180,"Brownsville-Harlingen, TX Metro Area",Bus,2016,247,103,350,0,
729,15180,"Brownsville-Harlingen, TX Metro Area",Bus,2017,142,38,180,0,
730,15180,"Brownsville-Harlingen, TX Metro Area",Bus,2018,151,17,168,0,
731,15380,"Buffalo-Niagara Falls, NY Metro Area",Bus,2002,1385,2128,3513,0,
732,15380,"Buffalo-Niagara Falls, NY Metro Area",Bus,2003,1978,2885,4863,0,
733,15380,"Buffalo-Niagara Falls, NY Metro Area",Bus,2004,1711,2771,4482,0,
734,15380,"Buffalo-Niagara Falls, NY Metro Area",Bus,2005,1722,2718,4440,0,
735,15380,"Buffalo-Niagara Falls, NY Metro Area",Bus,2006,1810,2877,4687,0,
736,15380,"Buffalo-Niagara Falls, NY Metro Area",Bus,2007,1732,2935,4667,0,
737,15380,"Buffalo-Niagara Falls, NY Metro Area",Bus,2008,1686,3272,4958,0,
738,15380,"Buffalo-Niagara Falls, NY Metro Area",Bus,2009,1453,2808,4261,0,
739,15380,"Buffalo-Niagara Falls, NY Metro Area",Bus,2010,1606,2761,4367,0,
740,15380,"Buffalo-Niagara Falls, NY Metro Area",Bus,2011,1434,2670,4104,0,
741,15380,"Buffalo-Niagara Falls, NY Metro Area",Bus,2012,1078,1947,3025,0,
742,15380,"Buffalo-Niagara Falls, NY Metro Area",Bus,2013,904,1936,2840,0,
743,15380,"Buffalo-Niagara Falls, NY Metro Area",Bus,2014,951,1986,2937,0,
744,15380,"Buffalo-Niagara Falls, NY Metro Area",Bus,2015,880,1473,2353,0,
745,15380,"Buffalo-Niagara Falls, NY Metro Area",Bus,2016,985,1533,2518,0,
746,15380,"Buffalo-Niagara Falls, NY Metro Area",Bus,2017,786,1519,2305,0,
747,15380,"Buffalo-Niagara Falls, NY Metro Area",Bus,2018,726,1329,2055,0,
748,15380,"Buffalo-Niagara Falls, NY Metro Area",Rail,2002,3,6,9,1,Other not reported
749,15380,"Buffalo-Niagara Falls, NY Metro Area",Rail,2003,3,3,6,1,Other not reported
750,15380,"Buffalo-Niagara Falls, NY Metro Area",Rail,2004,3,4,7,1,Other not reported
751,15380,"Buffalo-Niagara Falls, NY Metro Area",Rail,2005,18,11,29,0,
752,15380,"Buffalo-Niagara Falls, NY Metro Area",Rail,2006,3,28,31,0,
753,15380,"Buffalo-Niagara Falls, NY Metro Area",Rail,2007,4,33,37,0,
754,15380,"Buffalo-Niagara Falls, NY Metro Area",Rail,2008,3,36,39,0,
755,15380,"Buffalo-Niagara Falls, NY Metro Area",Rail,2009,3,42,45,0,
756,15380,"Buffalo-Niagara Falls, NY Metro Area",Rail,2010,3,45,48,0,
757,15380,"Buffalo-Niagara Falls, NY Metro Area",Rail,2011,4,47,51,0,
758,15380,"Buffalo-Niagara Falls, NY Metro Area",Rail,2012,2,47,49,0,
759,15380,"Buffalo-Niagara Falls, NY Metro Area",Rail,2013,1,49,50,0,
760,15380,"Buffalo-Niagara Falls, NY Metro Area",Rail,2014,3,64,67,0,
761,15380,"Buffalo-Niagara Falls, NY Metro Area",Rail,2015,7,44,51,0,
762,15380,"Buffalo-Niagara Falls, NY Metro Area",Rail,2016,5,51,56,0,
763,15380,"Buffalo-Niagara Falls, NY Metro Area",Rail,2017,7,41,48,0,
764,15380,"Buffalo-Niagara Falls, NY Metro Area",Rail,2018,54,9,63,0,
765,15540,"Burlington-South Burlington, VT Metro Area",Bus,2002,52,58,110,0,
766,15540,"Burlington-South Burlington, VT Metro Area",Bus,2003,53,70,123,0,
767,15540,"Burlington-South Burlington, VT Metro Area",Bus,2004,51,120,171,0,
768,15540,"Burlington-South Burlington, VT Metro Area",Bus,2005,55,104,159,0,
769,15540,"Burlington-South Burlington, VT Metro Area",Bus,2006,109,155,264,0,
770,15540,"Burlington-South Burlington, VT Metro Area",Bus,2007,117,158,275,0,
771,15540,"Burlington-South Burlington, VT Metro Area",Bus,2008,109,174,283,0,
772,15540,"Burlington-South Burlington, VT Metro Area",Bus,2009,90,23,113,0,
773,15540,"Burlington-South Burlington, VT Metro Area",Bus,2010,85,15,100,0,
774,15540,"Burlington-South Burlington, VT Metro Area",Bus,2011,83,12,95,0,
775,15540,"Burlington-South Burlington, VT Metro Area",Bus,2012,47,5,52,0,
776,15540,"Burlington-South Burlington, VT Metro Area",Bus,2013,56,40,96,0,
777,15540,"Burlington-South Burlington, VT Metro Area",Bus,2014,59,46,105,0,
778,15540,"Burlington-South Burlington, VT Metro Area",Bus,2015,47,30,77,0,
779,15540,"Burlington-South Burlington, VT Metro Area",Bus,2016,98,108,206,0,
780,15540,"Burlington-South Burlington, VT Metro Area",Bus,2017,121,137,258,0,
781,15540,"Burlington-South Burlington, VT Metro Area",Bus,2018,84,110,194,0,
782,15940,"Canton-Massillon, OH Metro Area",Bus,2002,3,511,514,0,
783,15940,"Canton-Massillon, OH Metro Area",Bus,2003,238,253,491,0,
784,15940,"Canton-Massillon, OH Metro Area",Bus,2004,114,118,232,0,
785,15940,"Canton-Massillon, OH Metro Area",Bus,2005,103,113,216,0,
786,15940,"Canton-Massillon, OH Metro Area",Bus,2006,118,120,238,0,
787,15940,"Canton-Massillon, OH Metro Area",Bus,2007,129,107,236,0,
788,15940,"Canton-Massillon, OH Metro Area",Bus,2008,117,184,301,0,
789,15940,"Canton-Massillon, OH Metro Area",Bus,2009,144,177,321,0,
790,15940,"Canton-Massillon, OH Metro Area",Bus,2010,44,143,187,0,
791,15940,"Canton-Massillon, OH Metro Area",Bus,2011,94,117,211,0,
792,15940,"Canton-Massillon, OH Metro Area",Bus,2012,86,85,171,0,
793,15940,"Canton-Massillon, OH Metro Area",Bus,2013,94,103,197,0,
794,15940,"Canton-Massillon, OH Metro Area",Bus,2014,26,113,139,0,
795,15940,"Canton-Massillon, OH Metro Area",Bus,2015,84,79,163,0,
796,15940,"Canton-Massillon, OH Metro Area",Bus,2016,136,389,525,0,
797,15940,"Canton-Massillon, OH Metro Area",Bus,2017,119,431,550,0,
798,15940,"Canton-Massillon, OH Metro Area",Bus,2018,105,841,946,0,
595,15980,"Cape Coral-Fort Myers, FL Metro Area",Bus,2002,0,0,0,1,Not reported
799,15980,"Cape Coral-Fort Myers, FL Metro Area",Bus,2002,377,247,624,0,
597,15980,"Cape Coral-Fort Myers, FL Metro Area",Bus,2003,0,0,0,1,Not reported
800,15980,"Cape Coral-Fort Myers, FL Metro Area",Bus,2003,168,157,325,0,
599,15980,"Cape Coral-Fort Myers, FL Metro Area",Bus,2004,0,0,0,1,Not reported
801,15980,"Cape Coral-Fort Myers, FL Metro Area",Bus,2004,175,438,613,0,
601,15980,"Cape Coral-Fort Myers, FL Metro Area",Bus,2005,0,0,0,1,Not reported
802,15980,"Cape Coral-Fort Myers, FL Metro Area",Bus,2005,135,310,445,0,
603,15980,"Cape Coral-Fort Myers, FL Metro Area",Bus,2006,0,0,0,1,Not reported
803,15980,"Cape Coral-Fort Myers, FL Metro Area",Bus,2006,86,285,371,0,
605,15980,"Cape Coral-Fort Myers, FL Metro Area",Bus,2007,0,0,0,1,Not reported
804,15980,"Cape Coral-Fort Myers, FL Metro Area",Bus,2007,58,99,157,0,
607,15980,"Cape Coral-Fort Myers, FL Metro Area",Bus,2008,0,0,0,1,Not reported
805,15980,"Cape Coral-Fort Myers, FL Metro Area",Bus,2008,157,193,350,0,
609,15980,"Cape Coral-Fort Myers, FL Metro Area",Bus,2009,109,33,142,0,
806,15980,"Cape Coral-Fort Myers, FL Metro Area",Bus,2009,155,134,289,0,
611,15980,"Cape Coral-Fort Myers, FL Metro Area",Bus,2010,105,21,126,0,
807,15980,"Cape Coral-Fort Myers, FL Metro Area",Bus,2010,127,133,260,0,
613,15980,"Cape Coral-Fort Myers, FL Metro Area",Bus,2011,77,11,88,0,
808,15980,"Cape Coral-Fort Myers, FL Metro Area",Bus,2011,112,99,211,0,
615,15980,"Cape Coral-Fort Myers, FL Metro Area",Bus,2012,68,9,77,0,
809,15980,"Cape Coral-Fort Myers, FL Metro Area",Bus,2012,129,99,228,0,
617,15980,"Cape Coral-Fort Myers, FL Metro Area",Bus,2013,52,2,54,0,
810,15980,"Cape Coral-Fort Myers, FL Metro Area",Bus,2013,71,72,143,0,
619,15980,"Cape Coral-Fort Myers, FL Metro Area",Bus,2014,28,1,29,0,
811,15980,"Cape Coral-Fort Myers, FL Metro Area",Bus,2014,65,45,110,0,
621,15980,"Cape Coral-Fort Myers, FL Metro Area",Bus,2015,31,0,31,0,
812,15980,"Cape Coral-Fort Myers, FL Metro Area",Bus,2015,80,35,115,0,
623,15980,"Cape Coral-Fort Myers, FL Metro Area",Bus,2016,23,0,23,0,
813,15980,"Cape Coral-Fort Myers, FL Metro Area",Bus,2016,92,34,126,0,
625,15980,"Cape Coral-Fort Myers, FL Metro Area",Bus,2017,94,27,121,0,
814,15980,"Cape Coral-Fort Myers, FL Metro Area",Bus,2017,112,9,121,0,
627,15980,"Cape Coral-Fort Myers, FL Metro Area",Bus,2018,98,54,152,0,
815,15980,"Cape Coral-Fort Myers, FL Metro Area",Bus,2018,97,38,135,0,
833,16300,"Cedar Rapids, IA Metro Area",Bus,2002,213,64,277,0,
834,16300,"Cedar Rapids, IA Metro Area",Bus,2003,131,87,218,0,
835,16300,"Cedar Rapids, IA Metro Area",Bus,2004,229,77,306,0,
836,16300,"Cedar Rapids, IA Metro Area",Bus,2005,234,80,314,0,
837,16300,"Cedar Rapids, IA Metro Area",Bus,2006,198,112,310,0,
838,16300,"Cedar Rapids, IA Metro Area",Bus,2007,277,87,364,0,
839,16300,"Cedar Rapids, IA Metro Area",Bus,2008,0,0,0,1,Not reported
840,16300,"Cedar Rapids, IA Metro Area",Bus,2009,162,96,258,0,
841,16300,"Cedar Rapids, IA Metro Area",Bus,2010,74,71,145,0,
842,16300,"Cedar Rapids, IA Metro Area",Bus,2011,74,104,178,0,
843,16300,"Cedar Rapids, IA Metro Area",Bus,2012,48,80,128,0,
844,16300,"Cedar Rapids, IA Metro Area",Bus,2013,49,109,158,0,
845,16300,"Cedar Rapids, IA Metro Area",Bus,2014,49,72,121,0,
846,16300,"Cedar Rapids, IA Metro Area",Bus,2015,32,56,88,0,
847,16300,"Cedar Rapids, IA Metro Area",Bus,2016,25,78,103,0,
848,16300,"Cedar Rapids, IA Metro Area",Bus,2017,31,74,105,0,
849,16300,"Cedar Rapids, IA Metro Area",Bus,2018,25,80,105,0,
850,16580,"Champaign-Urbana, IL Metro Area",Bus,2002,139,100,239,0,
851,16580,"Champaign-Urbana, IL Metro Area",Bus,2003,65,168,233,0,
852,16580,"Champaign-Urbana, IL Metro Area",Bus,2004,73,178,251,0,
853,16580,"Champaign-Urbana, IL Metro Area",Bus,2005,51,125,176,0,
854,16580,"Champaign-Urbana, IL Metro Area",Bus,2006,24,114,138,0,
855,16580,"Champaign-Urbana, IL Metro Area",Bus,2007,63,23,86,0,
856,16580,"Champaign-Urbana, IL Metro Area",Bus,2008,103,42,145,0,
857,16580,"Champaign-Urbana, IL Metro Area",Bus,2009,124,48,172,0,
858,16580,"Champaign-Urbana, IL Metro Area",Bus,2010,131,50,181,0,
859,16580,"Champaign-Urbana, IL Metro Area",Bus,2011,128,32,160,0,
860,16580,"Champaign-Urbana, IL Metro Area",Bus,2012,108,31,139,0,
861,16580,"Champaign-Urbana, IL Metro Area",Bus,2013,84,43,127,0,
862,16580,"Champaign-Urbana, IL Metro Area",Bus,2014,75,40,115,0,
863,16580,"Champaign-Urbana, IL Metro Area",Bus,2015,65,47,112,0,
864,16580,"Champaign-Urbana, IL Metro Area",Bus,2016,85,46,131,0,
865,16580,"Champaign-Urbana, IL Metro Area",Bus,2017,89,41,130,0,
866,16580,"Champaign-Urbana, IL Metro Area",Bus,2018,200,229,429,0,
867,16620,"Charleston, WV Metro Area",Bus,2002,16,1160,1176,0,
2193,16620,"Charleston, WV Metro Area",Bus,2002,0,403,403,0,
868,16620,"Charleston, WV Metro Area",Bus,2003,12,1315,1327,0,
2195,16620,"Charleston, WV Metro Area",Bus,2003,0,346,346,0,
869,16620,"Charleston, WV Metro Area",Bus,2004,11,1257,1268,0,
2197,16620,"Charleston, WV Metro Area",Bus,2004,2,326,328,0,
870,16620,"Charleston, WV Metro Area",Bus,2005,8,1013,1021,0,
2199,16620,"Charleston, WV Metro Area",Bus,2005,0,269,269,0,
871,16620,"Charleston, WV Metro Area",Bus,2006,10,1019,1029,0,
2201,16620,"Charleston, WV Metro Area",Bus,2006,0,198,198,0,
872,16620,"Charleston, WV Metro Area",Bus,2007,5,1071,1076,0,
2203,16620,"Charleston, WV Metro Area",Bus,2007,0,352,352,0,
873,16620,"Charleston, WV Metro Area",Bus,2008,9,1113,1122,0,
2205,16620,"Charleston, WV Metro Area",Bus,2008,0,454,454,0,
874,16620,"Charleston, WV Metro Area",Bus,2009,286,846,1132,0,
2207,16620,"Charleston, WV Metro Area",Bus,2009,2,261,263,0,
875,16620,"Charleston, WV Metro Area",Bus,2010,178,807,985,0,
2209,16620,"Charleston, WV Metro Area",Bus,2010,0,217,217,0,
876,16620,"Charleston, WV Metro Area",Bus,2011,338,734,1072,0,
2211,16620,"Charleston, WV Metro Area",Bus,2011,4,236,240,0,
877,16620,"Charleston, WV Metro Area",Bus,2012,370,667,1037,0,
2213,16620,"Charleston, WV Metro Area",Bus,2012,8,337,345,0,
878,16620,"Charleston, WV Metro Area",Bus,2013,250,649,899,0,
2215,16620,"Charleston, WV Metro Area",Bus,2013,5,296,301,0,
879,16620,"Charleston, WV Metro Area",Bus,2014,208,548,756,0,
2217,16620,"Charleston, WV Metro Area",Bus,2014,92,24,116,0,
880,16620,"Charleston, WV Metro Area",Bus,2015,294,793,1087,0,
2219,16620,"Charleston, WV Metro Area",Bus,2015,2,224,226,0,
881,16620,"Charleston, WV Metro Area",Bus,2016,283,764,1047,0,
2221,16620,"Charleston, WV Metro Area",Bus,2016,2,275,277,0,
882,16620,"Charleston, WV Metro Area",Bus,2017,296,753,1049,0,
2223,16620,"Charleston, WV Metro Area",Bus,2017,2,356,358,0,
883,16620,"Charleston, WV Metro Area",Bus,2018,259,850,1109,0,
2225,16620,"Charleston, WV Metro Area",Bus,2018,12,296,308,0,
884,16700,"Charleston-North Charleston-Summerville, SC Metro Area",Bus,2002,0,0,0,1,Not reported
885,16700,"Charleston-North Charleston-Summerville, SC Metro Area",Bus,2003,0,0,0,1,Not reported
886,16700,"Charleston-North Charleston-Summerville, SC Metro Area",Bus,2004,0,0,0,1,Not reported
887,16700,"Charleston-North Charleston-Summerville, SC Metro Area",Bus,2005,0,0,0,1,Not reported
888,16700,"Charleston-North Charleston-Summerville, SC Metro Area",Bus,2006,0,0,0,1,Not reported
889,16700,"Charleston-North Charleston-Summerville, SC Metro Area",Bus,2007,0,0,0,1,Not reported
890,16700,"Charleston-North Charleston-Summerville, SC Metro Area",Bus,2008,17,57,74,1,Under-reported
891,16700,"Charleston-North Charleston-Summerville, SC Metro Area",Bus,2009,128,425,553,0,
892,16700,"Charleston-North Charleston-Summerville, SC Metro Area",Bus,2010,99,378,477,0,
893,16700,"Charleston-North Charleston-Summerville, SC Metro Area",Bus,2011,15,221,236,0,
894,16700,"Charleston-North Charleston-Summerville, SC Metro Area",Bus,2012,10,185,195,0,
895,16700,"Charleston-North Charleston-Summerville, SC Metro Area",Bus,2013,185,32,217,0,
896,16700,"Charleston-North Charleston-Summerville, SC Metro Area",Bus,2014,221,31,252,0,
897,16700,"Charleston-North Charleston-Summerville, SC Metro Area",Bus,2015,161,36,197,0,
898,16700,"Charleston-North Charleston-Summerville, SC Metro Area",Bus,2016,133,27,160,0,
899,16700,"Charleston-North Charleston-Summerville, SC Metro Area",Bus,2017,177,36,213,0,
900,16700,"Charleston-North Charleston-Summerville, SC Metro Area",Bus,2018,154,32,186,0,
901,16740,"Charlotte-Gastonia-Rock Hill, NC-SC Metro Area",Bus,2002,819,3708,4527,0,
902,16740,"Charlotte-Gastonia-Rock Hill, NC-SC Metro Area",Bus,2003,1278,4251,5529,0,
903,16740,"Charlotte-Gastonia-Rock Hill, NC-SC Metro Area",Bus,2004,712,3914,4626,0,
904,16740,"Charlotte-Gastonia-Rock Hill, NC-SC Metro Area",Bus,2005,767,8339,9106,0,
905,16740,"Charlotte-Gastonia-Rock Hill, NC-SC Metro Area",Bus,2006,907,10002,10909,0,
906,16740,"Charlotte-Gastonia-Rock Hill, NC-SC Metro Area",Bus,2007,1359,10172,11531,0,
907,16740,"Charlotte-Gastonia-Rock Hill, NC-SC Metro Area",Bus,2008,887,10684,11571,0,
908,16740,"Charlotte-Gastonia-Rock Hill, NC-SC Metro Area",Bus,2009,874,11023,11897,0,
909,16740,"Charlotte-Gastonia-Rock Hill, NC-SC Metro Area",Bus,2010,911,11063,11974,0,
910,16740,"Charlotte-Gastonia-Rock Hill, NC-SC Metro Area",Bus,2011,859,6539,7398,0,
911,16740,"Charlotte-Gastonia-Rock Hill, NC-SC Metro Area",Bus,2012,883,9199,10082,0,
912,16740,"Charlotte-Gastonia-Rock Hill, NC-SC Metro Area",Bus,2013,872,8863,9735,0,
913,16740,"Charlotte-Gastonia-Rock Hill, NC-SC Metro Area",Bus,2014,937,15047,15984,0,
914,16740,"Charlotte-Gastonia-Rock Hill, NC-SC Metro Area",Bus,2015,996,6607,7603,0,
915,16740,"Charlotte-Gastonia-Rock Hill, NC-SC Metro Area",Bus,2016,622,1954,2576,0,
916,16740,"Charlotte-Gastonia-Rock Hill, NC-SC Metro Area",Bus,2017,880,1883,2763,0,
917,16740,"Charlotte-Gastonia-Rock Hill, NC-SC Metro Area",Bus,2018,908,2634,3542,0,
918,16740,"Charlotte-Gastonia-Rock Hill, NC-SC Metro Area",Rail,2002,0,0,0,1,Not reported
919,16740,"Charlotte-Gastonia-Rock Hill, NC-SC Metro Area",Rail,2003,0,0,0,1,Not reported
920,16740,"Charlotte-Gastonia-Rock Hill, NC-SC Metro Area",Rail,2004,0,0,0,1,Not reported
921,16740,"Charlotte-Gastonia-Rock Hill, NC-SC Metro Area",Rail,2005,5,7,12,0,
922,16740,"Charlotte-Gastonia-Rock Hill, NC-SC Metro Area",Rail,2006,4,0,4,0,
923,16740,"Charlotte-Gastonia-Rock Hill, NC-SC Metro Area",Rail,2007,0,0,0,0,
924,16740,"Charlotte-Gastonia-Rock Hill, NC-SC Metro Area",Rail,2008,19,0,19,0,
925,16740,"Charlotte-Gastonia-Rock Hill, NC-SC Metro Area",Rail,2009,80,4,84,0,
926,16740,"Charlotte-Gastonia-Rock Hill, NC-SC Metro Area",Rail,2010,76,38,114,0,
927,16740,"Charlotte-Gastonia-Rock Hill, NC-SC Metro Area",Rail,2011,71,49,120,0,
928,16740,"Charlotte-Gastonia-Rock Hill, NC-SC Metro Area",Rail,2012,89,31,120,0,
929,16740,"Charlotte-Gastonia-Rock Hill, NC-SC Metro Area",Rail,2013,86,8,94,0,
930,16740,"Charlotte-Gastonia-Rock Hill, NC-SC Metro Area",Rail,2014,111,6,117,0,
931,16740,"Charlotte-Gastonia-Rock Hill, NC-SC Metro Area",Rail,2015,95,2,97,0,
932,16740,"Charlotte-Gastonia-Rock Hill, NC-SC Metro Area",Rail,2016,280,40,320,0,
933,16740,"Charlotte-Gastonia-Rock Hill, NC-SC Metro Area",Rail,2017,274,44,318,0,
934,16740,"Charlotte-Gastonia-Rock Hill, NC-SC Metro Area",Rail,2018,410,35,445,0,
935,16860,"Chattanooga, TN-GA Metro Area",Bus,2002,8,287,295,0,
936,16860,"Chattanooga, TN-GA Metro Area",Bus,2003,9,279,288,0,
937,16860,"Chattanooga, TN-GA Metro Area",Bus,2004,8,284,292,0,
938,16860,"Chattanooga, TN-GA Metro Area",Bus,2005,7,277,284,0,
939,16860,"Chattanooga, TN-GA Metro Area",Bus,2006,8,283,291,0,
940,16860,"Chattanooga, TN-GA Metro Area",Bus,2007,136,314,450,0,
941,16860,"Chattanooga, TN-GA Metro Area",Bus,2008,204,284,488,0,
942,16860,"Chattanooga, TN-GA Metro Area",Bus,2009,128,313,441,0,
943,16860,"Chattanooga, TN-GA Metro Area",Bus,2010,147,462,609,0,
944,16860,"Chattanooga, TN-GA Metro Area",Bus,2011,214,395,609,0,
945,16860,"Chattanooga, TN-GA Metro Area",Bus,2012,219,460,679,0,
946,16860,"Chattanooga, TN-GA Metro Area",Bus,2013,239,399,638,0,
947,16860,"Chattanooga, TN-GA Metro Area",Bus,2014,222,178,400,0,
948,16860,"Chattanooga, TN-GA Metro Area",Bus,2015,161,80,241,0,
949,16860,"Chattanooga, TN-GA Metro Area",Bus,2016,207,128,335,0,
950,16860,"Chattanooga, TN-GA Metro Area",Bus,2017,201,109,310,0,
951,16860,"Chattanooga, TN-GA Metro Area",Bus,2018,215,114,329,0,
952,16860,"Chattanooga, TN-GA Metro Area",Rail,2002,0,5,5,0,
953,16860,"Chattanooga, TN-GA Metro Area",Rail,2003,0,6,6,0,
954,16860,"Chattanooga, TN-GA Metro Area",Rail,2004,0,7,7,0,
955,16860,"Chattanooga, TN-GA Metro Area",Rail,2005,0,6,6,0,
956,16860,"Chattanooga, TN-GA Metro Area",Rail,2006,0,5,5,0,
957,16860,"Chattanooga, TN-GA Metro Area",Rail,2007,2,7,9,0,
958,16860,"Chattanooga, TN-GA Metro Area",Rail,2008,2,0,2,0,
959,16860,"Chattanooga, TN-GA Metro Area",Rail,2009,1,0,1,0,
960,16860,"Chattanooga, TN-GA Metro Area",Rail,2010,3,0,3,0,
961,16860,"Chattanooga, TN-GA Metro Area",Rail,2011,7,0,7,0,
962,16860,"Chattanooga, TN-GA Metro Area",Rail,2012,117,0,117,0,
963,16860,"Chattanooga, TN-GA Metro Area",Rail,2013,0,0,0,0,
964,16860,"Chattanooga, TN-GA Metro Area",Rail,2014,2,0,2,0,
965,16860,"Chattanooga, TN-GA Metro Area",Rail,2015,1,0,1,0,
966,16860,"Chattanooga, TN-GA Metro Area",Rail,2016,1,0,1,0,
967,16860,"Chattanooga, TN-GA Metro Area",Rail,2017,0,0,0,0,
968,16860,"Chattanooga, TN-GA Metro Area",Rail,2018,1,0,1,0,
969,16980,"Chicago-Joliet-Naperville, IL-IN-WI Metro Area",Bus,2002,19614,1917,21531,0,
2516,16980,"Chicago-Joliet-Naperville, IL-IN-WI Metro Area",Bus,2002,52,215,267,0,
970,16980,"Chicago-Joliet-Naperville, IL-IN-WI Metro Area",Bus,2003,18329,1335,19664,0,
2517,16980,"Chicago-Joliet-Naperville, IL-IN-WI Metro Area",Bus,2003,64,338,402,0,
971,16980,"Chicago-Joliet-Naperville, IL-IN-WI Metro Area",Bus,2004,16929,1152,18081,0,
2518,16980,"Chicago-Joliet-Naperville, IL-IN-WI Metro Area",Bus,2004,180,197,377,0,
972,16980,"Chicago-Joliet-Naperville, IL-IN-WI Metro Area",Bus,2005,18698,828,19526,0,
2519,16980,"Chicago-Joliet-Naperville, IL-IN-WI Metro Area",Bus,2005,99,91,190,0,
973,16980,"Chicago-Joliet-Naperville, IL-IN-WI Metro Area",Bus,2006,18640,673,19313,0,
2520,16980,"Chicago-Joliet-Naperville, IL-IN-WI Metro Area",Bus,2006,66,102,168,0,
974,16980,"Chicago-Joliet-Naperville, IL-IN-WI Metro Area",Bus,2007,14790,6514,21304,0,
2521,16980,"Chicago-Joliet-Naperville, IL-IN-WI Metro Area",Bus,2007,34,132,166,0,
975,16980,"Chicago-Joliet-Naperville, IL-IN-WI Metro Area",Bus,2008,13477,9130,22607,0,
2522,16980,"Chicago-Joliet-Naperville, IL-IN-WI Metro Area",Bus,2008,94,84,178,0,
976,16980,"Chicago-Joliet-Naperville, IL-IN-WI Metro Area",Bus,2009,10001,15553,25554,0,
2523,16980,"Chicago-Joliet-Naperville, IL-IN-WI Metro Area",Bus,2009,63,101,164,0,
977,16980,"Chicago-Joliet-Naperville, IL-IN-WI Metro Area",Bus,2010,7777,12183,19960,0,
2524,16980,"Chicago-Joliet-Naperville, IL-IN-WI Metro Area",Bus,2010,56,85,141,0,
978,16980,"Chicago-Joliet-Naperville, IL-IN-WI Metro Area",Bus,2011,8204,11772,19976,0,
2525,16980,"Chicago-Joliet-Naperville, IL-IN-WI Metro Area",Bus,2011,34,37,71,0,
979,16980,"Chicago-Joliet-Naperville, IL-IN-WI Metro Area",Bus,2012,7624,11391,19015,0,
2526,16980,"Chicago-Joliet-Naperville, IL-IN-WI Metro Area",Bus,2012,25,21,46,0,
980,16980,"Chicago-Joliet-Naperville, IL-IN-WI Metro Area",Bus,2013,8890,11155,20045,0,
2527,16980,"Chicago-Joliet-Naperville, IL-IN-WI Metro Area",Bus,2013,47,32,79,0,
981,16980,"Chicago-Joliet-Naperville, IL-IN-WI Metro Area",Bus,2014,10838,10550,21388,0,
2528,16980,"Chicago-Joliet-Naperville, IL-IN-WI Metro Area",Bus,2014,45,29,74,0,
982,16980,"Chicago-Joliet-Naperville, IL-IN-WI Metro Area",Bus,2015,8074,9731,17805,0,
2529,16980,"Chicago-Joliet-Naperville, IL-IN-WI Metro Area",Bus,2015,49,27,76,0,
983,16980,"Chicago-Joliet-Naperville, IL-IN-WI Metro Area",Bus,2016,10898,10088,20986,0,
2530,16980,"Chicago-Joliet-Naperville, IL-IN-WI Metro Area",Bus,2016,34,12,46,0,
984,16980,"Chicago-Joliet-Naperville, IL-IN-WI Metro Area",Bus,2017,11262,7997,19259,0,
2531,16980,"Chicago-Joliet-Naperville, IL-IN-WI Metro Area",Bus,2017,30,11,41,0,
985,16980,"Chicago-Joliet-Naperville, IL-IN-WI Metro Area",Bus,2018,11465,7969,19434,0,
2532,16980,"Chicago-Joliet-Naperville, IL-IN-WI Metro Area",Bus,2018,37,22,59,0,
986,16980,"Chicago-Joliet-Naperville, IL-IN-WI Metro Area",Rail,2002,230,29,259,1,inconsistent
2533,16980,"Chicago-Joliet-Naperville, IL-IN-WI Metro Area",Rail,2002,4,1,5,0,
987,16980,"Chicago-Joliet-Naperville, IL-IN-WI Metro Area",Rail,2003,191,15,206,1,inconsistent
2534,16980,"Chicago-Joliet-Naperville, IL-IN-WI Metro Area",Rail,2003,3,0,3,0,
988,16980,"Chicago-Joliet-Naperville, IL-IN-WI Metro Area",Rail,2004,166,25,191,1,inconsistent
2535,16980,"Chicago-Joliet-Naperville, IL-IN-WI Metro Area",Rail,2004,4,2,6,0,
989,16980,"Chicago-Joliet-Naperville, IL-IN-WI Metro Area",Rail,2005,353,43,396,1,inconsistent
2536,16980,"Chicago-Joliet-Naperville, IL-IN-WI Metro Area",Rail,2005,5,2,7,0,
990,16980,"Chicago-Joliet-Naperville, IL-IN-WI Metro Area",Rail,2006,348,19173,19521,0,
2537,16980,"Chicago-Joliet-Naperville, IL-IN-WI Metro Area",Rail,2006,2,2,4,0,
991,16980,"Chicago-Joliet-Naperville, IL-IN-WI Metro Area",Rail,2007,341,25049,25390,0,
2538,16980,"Chicago-Joliet-Naperville, IL-IN-WI Metro Area",Rail,2007,2,3,5,0,
992,16980,"Chicago-Joliet-Naperville, IL-IN-WI Metro Area",Rail,2008,356,20959,21315,0,
2539,16980,"Chicago-Joliet-Naperville, IL-IN-WI Metro Area",Rail,2008,4,5,9,0,
993,16980,"Chicago-Joliet-Naperville, IL-IN-WI Metro Area",Rail,2009,300,17742,18042,0,
2540,16980,"Chicago-Joliet-Naperville, IL-IN-WI Metro Area",Rail,2009,2,6,8,0,
994,16980,"Chicago-Joliet-Naperville, IL-IN-WI Metro Area",Rail,2010,313,18208,18521,0,
2541,16980,"Chicago-Joliet-Naperville, IL-IN-WI Metro Area",Rail,2010,2,0,2,0,
995,16980,"Chicago-Joliet-Naperville, IL-IN-WI Metro Area",Rail,2011,363,17977,18340,0,
2542,16980,"Chicago-Joliet-Naperville, IL-IN-WI Metro Area",Rail,2011,5,0,5,0,
996,16980,"Chicago-Joliet-Naperville, IL-IN-WI Metro Area",Rail,2012,361,18125,18486,0,
2543,16980,"Chicago-Joliet-Naperville, IL-IN-WI Metro Area",Rail,2012,6,1,7,0,
997,16980,"Chicago-Joliet-Naperville, IL-IN-WI Metro Area",Rail,2013,381,16694,17075,0,
2544,16980,"Chicago-Joliet-Naperville, IL-IN-WI Metro Area",Rail,2013,4,3,7,0,
998,16980,"Chicago-Joliet-Naperville, IL-IN-WI Metro Area",Rail,2014,458,13725,14183,0,
2545,16980,"Chicago-Joliet-Naperville, IL-IN-WI Metro Area",Rail,2014,5,1,6,0,
999,16980,"Chicago-Joliet-Naperville, IL-IN-WI Metro Area",Rail,2015,321,11097,11418,0,
2546,16980,"Chicago-Joliet-Naperville, IL-IN-WI Metro Area",Rail,2015,8,6,14,0,
1000,16980,"Chicago-Joliet-Naperville, IL-IN-WI Metro Area",Rail,2016,336,9117,9453,0,
2547,16980,"Chicago-Joliet-Naperville, IL-IN-WI Metro Area",Rail,2016,0,4,4,0,
1001,16980,"Chicago-Joliet-Naperville, IL-IN-WI Metro Area",Rail,2017,396,9886,10282,0,
2548,16980,"Chicago-Joliet-Naperville, IL-IN-WI Metro Area",Rail,2017,0,2,2,0,
1002,16980,"Chicago-Joliet-Naperville, IL-IN-WI Metro Area",Rail,2018,561,10217,10778,0,
2549,16980,"Chicago-Joliet-Naperville, IL-IN-WI Metro Area",Rail,2018,0,2,2,0,
1003,17020,"Chico, CA Metro Area",Bus,2002,0,0,0,1,Not reported
1004,17020,"Chico, CA Metro Area",Bus,2003,0,0,0,1,Not reported
1005,17020,"Chico, CA Metro Area",Bus,2004,0,0,0,1,Not reported
1006,17020,"Chico, CA Metro Area",Bus,2005,0,0,0,1,Not reported
1007,17020,"Chico, CA Metro Area",Bus,2006,0,0,0,1,Not reported
1008,17020,"Chico, CA Metro Area",Bus,2007,0,0,0,1,Not reported
1009,17020,"Chico, CA Metro Area",Bus,2008,0,0,0,1,Not reported
1010,17020,"Chico, CA Metro Area",Bus,2009,44,21,65,0,
1011,17020,"Chico, CA Metro Area",Bus,2010,64,18,82,0,
1012,17020,"Chico, CA Metro Area",Bus,2011,42,21,63,0,
1013,17020,"Chico, CA Metro Area",Bus,2012,36,18,54,0,
1014,17020,"Chico, CA Metro Area",Bus,2013,35,20,55,0,
1015,17020,"Chico, CA Metro Area",Bus,2014,42,39,81,0,
1016,17020,"Chico, CA Metro Area",Bus,2015,55,19,74,0,
1017,17020,"Chico, CA Metro Area",Bus,2016,44,27,71,0,
1018,17020,"Chico, CA Metro Area",Bus,2017,51,19,70,0,
1019,17020,"Chico, CA Metro Area",Bus,2018,35,21,56,0,
1020,17140,"Cincinnati-Middletown, OH-KY-IN Metro Area",Bus,2002,1283,382,1665,1,inconsistent
1021,17140,"Cincinnati-Middletown, OH-KY-IN Metro Area",Bus,2003,759,930,1689,1,inconsistent
1022,17140,"Cincinnati-Middletown, OH-KY-IN Metro Area",Bus,2004,608,896,1504,1,inconsistent
1023,17140,"Cincinnati-Middletown, OH-KY-IN Metro Area",Bus,2005,491,850,1341,1,inconsistent
1024,17140,"Cincinnati-Middletown, OH-KY-IN Metro Area",Bus,2006,601,900,1501,1,inconsistent
1025,17140,"Cincinnati-Middletown, OH-KY-IN Metro Area",Bus,2007,621,1068,1689,1,inconsistent
1026,17140,"Cincinnati-Middletown, OH-KY-IN Metro Area",Bus,2008,662,1057,1719,1,inconsistent
1027,17140,"Cincinnati-Middletown, OH-KY-IN Metro Area",Bus,2009,696,908,1604,1,inconsistent
1028,17140,"Cincinnati-Middletown, OH-KY-IN Metro Area",Bus,2010,542,803,1345,1,inconsistent
1029,17140,"Cincinnati-Middletown, OH-KY-IN Metro Area",Bus,2011,607,935,1542,1,inconsistent
1030,17140,"Cincinnati-Middletown, OH-KY-IN Metro Area",Bus,2012,585,1048,1633,1,inconsistent
1031,17140,"Cincinnati-Middletown, OH-KY-IN Metro Area",Bus,2013,2075,2768,4843,0,
1032,17140,"Cincinnati-Middletown, OH-KY-IN Metro Area",Bus,2014,2076,2099,4175,0,
1033,17140,"Cincinnati-Middletown, OH-KY-IN Metro Area",Bus,2015,2204,1578,3782,0,
1034,17140,"Cincinnati-Middletown, OH-KY-IN Metro Area",Bus,2016,2245,2040,4285,0,
1035,17140,"Cincinnati-Middletown, OH-KY-IN Metro Area",Bus,2017,2023,2135,4158,0,
1036,17140,"Cincinnati-Middletown, OH-KY-IN Metro Area",Bus,2018,1929,1666,3595,0,
1037,17140,"Cincinnati-Middletown, OH-KY-IN Metro Area",Rail,2002,0,0,0,1,Not reported
1038,17140,"Cincinnati-Middletown, OH-KY-IN Metro Area",Rail,2003,0,0,0,1,Not reported
1039,17140,"Cincinnati-Middletown, OH-KY-IN Metro Area",Rail,2004,0,0,0,1,Not reported
1040,17140,"Cincinnati-Middletown, OH-KY-IN Metro Area",Rail,2005,0,0,0,1,Not reported
1041,17140,"Cincinnati-Middletown, OH-KY-IN Metro Area",Rail,2006,0,0,0,1,Not reported
1042,17140,"Cincinnati-Middletown, OH-KY-IN Metro Area",Rail,2007,0,0,0,1,Not reported
1043,17140,"Cincinnati-Middletown, OH-KY-IN Metro Area",Rail,2008,0,0,0,1,Not reported
1044,17140,"Cincinnati-Middletown, OH-KY-IN Metro Area",Rail,2009,0,0,0,1,Not reported
1045,17140,"Cincinnati-Middletown, OH-KY-IN Metro Area",Rail,2010,0,0,0,1,Not reported
1046,17140,"Cincinnati-Middletown, OH-KY-IN Metro Area",Rail,2011,0,0,0,1,Not reported
1047,17140,"Cincinnati-Middletown, OH-KY-IN Metro Area",Rail,2012,0,0,0,1,Not reported
1048,17140,"Cincinnati-Middletown, OH-KY-IN Metro Area",Rail,2013,0,0,0,1,Not reported
1049,17140,"Cincinnati-Middletown, OH-KY-IN Metro Area",Rail,2014,0,0,0,1,Not reported
1050,17140,"Cincinnati-Middletown, OH-KY-IN Metro Area",Rail,2015,0,0,0,1,Not reported
1051,17140,"Cincinnati-Middletown, OH-KY-IN Metro Area",Rail,2016,31,5,36,0,
1052,17140,"Cincinnati-Middletown, OH-KY-IN Metro Area",Rail,2017,89,67,156,0,
1053,17140,"Cincinnati-Middletown, OH-KY-IN Metro Area",Rail,2018,94,56,150,0,
1054,17460,"Cleveland-Elyria-Mentor, OH Metro Area",Bus,2002,3359,807,4166,0,
1055,17460,"Cleveland-Elyria-Mentor, OH Metro Area",Bus,2003,2037,583,2620,0,
1056,17460,"Cleveland-Elyria-Mentor, OH Metro Area",Bus,2004,1693,418,2111,0,
1057,17460,"Cleveland-Elyria-Mentor, OH Metro Area",Bus,2005,1986,213,2199,0,
1058,17460,"Cleveland-Elyria-Mentor, OH Metro Area",Bus,2006,2011,297,2308,0,
1059,17460,"Cleveland-Elyria-Mentor, OH Metro Area",Bus,2007,1327,288,1615,0,
1060,17460,"Cleveland-Elyria-Mentor, OH Metro Area",Bus,2008,1866,207,2073,0,
1061,17460,"Cleveland-Elyria-Mentor, OH Metro Area",Bus,2009,891,109,1000,0,
1062,17460,"Cleveland-Elyria-Mentor, OH Metro Area",Bus,2010,1418,109,1527,0,
1063,17460,"Cleveland-Elyria-Mentor, OH Metro Area",Bus,2011,1920,519,2439,0,
1064,17460,"Cleveland-Elyria-Mentor, OH Metro Area",Bus,2012,1426,348,1774,0,
1065,17460,"Cleveland-Elyria-Mentor, OH Metro Area",Bus,2013,1356,238,1594,0,
1066,17460,"Cleveland-Elyria-Mentor, OH Metro Area",Bus,2014,1588,157,1745,0,
1067,17460,"Cleveland-Elyria-Mentor, OH Metro Area",Bus,2015,1060,376,1436,0,
1068,17460,"Cleveland-Elyria-Mentor, OH Metro Area",Bus,2016,1314,536,1850,0,
1069,17460,"Cleveland-Elyria-Mentor, OH Metro Area",Bus,2017,1039,188,1227,0,
1070,17460,"Cleveland-Elyria-Mentor, OH Metro Area",Bus,2018,718,156,874,0,
1071,17460,"Cleveland-Elyria-Mentor, OH Metro Area",Rail,2002,116,59,175,1,Not consistent
1072,17460,"Cleveland-Elyria-Mentor, OH Metro Area",Rail,2003,141,55,196,1,Not consistent
1073,17460,"Cleveland-Elyria-Mentor, OH Metro Area",Rail,2004,150,77,227,1,Not consistent
1074,17460,"Cleveland-Elyria-Mentor, OH Metro Area",Rail,2005,192,59,251,1,Not consistent
1075,17460,"Cleveland-Elyria-Mentor, OH Metro Area",Rail,2006,147,54,201,1,Not consistent
1076,17460,"Cleveland-Elyria-Mentor, OH Metro Area",Rail,2007,154,47,201,1,Not consistent
1077,17460,"Cleveland-Elyria-Mentor, OH Metro Area",Rail,2008,120,52,172,1,Not consistent
1078,17460,"Cleveland-Elyria-Mentor, OH Metro Area",Rail,2009,117,49,166,1,Not consistent
1079,17460,"Cleveland-Elyria-Mentor, OH Metro Area",Rail,2010,149,60,209,1,Not consistent
1080,17460,"Cleveland-Elyria-Mentor, OH Metro Area",Rail,2011,119,56,175,1,Not consistent
1081,17460,"Cleveland-Elyria-Mentor, OH Metro Area",Rail,2012,127,85,212,1,Not consistent
1082,17460,"Cleveland-Elyria-Mentor, OH Metro Area",Rail,2013,39,35,74,1,Not consistent
1083,17460,"Cleveland-Elyria-Mentor, OH Metro Area",Rail,2014,33,27,60,1,Not consistent
1084,17460,"Cleveland-Elyria-Mentor, OH Metro Area",Rail,2015,38,17,55,1,Not consistent
1085,17460,"Cleveland-Elyria-Mentor, OH Metro Area",Rail,2016,253,3161,3414,0,
1086,17460,"Cleveland-Elyria-Mentor, OH Metro Area",Rail,2017,228,2779,3007,0,
1087,17460,"Cleveland-Elyria-Mentor, OH Metro Area",Rail,2018,123,2411,2534,0,
1088,17780,"College Station-Bryan, TX Metro Area",Bus,2002,14,13,27,0,
1089,17780,"College Station-Bryan, TX Metro Area",Bus,2003,12,11,23,0,
1090,17780,"College Station-Bryan, TX Metro Area",Bus,2004,11,12,23,0,
1091,17780,"College Station-Bryan, TX Metro Area",Bus,2005,27,21,48,0,
1092,17780,"College Station-Bryan, TX Metro Area",Bus,2006,18,15,33,0,
1093,17780,"College Station-Bryan, TX Metro Area",Bus,2007,34,37,71,0,
1094,17780,"College Station-Bryan, TX Metro Area",Bus,2008,17,23,40,0,
1095,17780,"College Station-Bryan, TX Metro Area",Bus,2009,56,18,74,0,
1096,17780,"College Station-Bryan, TX Metro Area",Bus,2010,56,60,116,0,
1097,17780,"College Station-Bryan, TX Metro Area",Bus,2011,32,64,96,0,
1098,17780,"College Station-Bryan, TX Metro Area",Bus,2012,11,17,28,0,
1099,17780,"College Station-Bryan, TX Metro Area",Bus,2013,10,20,30,0,
1100,17780,"College Station-Bryan, TX Metro Area",Bus,2014,26,35,61,0,
1101,17780,"College Station-Bryan, TX Metro Area",Bus,2015,43,48,91,0,
1102,17780,"College Station-Bryan, TX Metro Area",Bus,2016,16,61,77,0,
1103,17780,"College Station-Bryan, TX Metro Area",Bus,2017,47,41,88,0,
1104,17780,"College Station-Bryan, TX Metro Area",Bus,2018,64,22,86,0,
1105,17820,"Colorado Springs, CO Metro Area",Bus,2002,434,369,803,0,
1106,17820,"Colorado Springs, CO Metro Area",Bus,2003,383,322,705,0,
1107,17820,"Colorado Springs, CO Metro Area",Bus,2004,406,353,759,0,
1108,17820,"Colorado Springs, CO Metro Area",Bus,2005,0,0,0,1,Not reported
1109,17820,"Colorado Springs, CO Metro Area",Bus,2006,0,0,0,1,Not reported
1110,17820,"Colorado Springs, CO Metro Area",Bus,2007,0,0,0,1,Not reported
1111,17820,"Colorado Springs, CO Metro Area",Bus,2008,58,13,71,1,Not reported
1112,17820,"Colorado Springs, CO Metro Area",Bus,2009,298,86,384,0,
1113,17820,"Colorado Springs, CO Metro Area",Bus,2010,260,72,332,0,
1114,17820,"Colorado Springs, CO Metro Area",Bus,2011,288,52,340,0,
1115,17820,"Colorado Springs, CO Metro Area",Bus,2012,183,185,368,0,
1116,17820,"Colorado Springs, CO Metro Area",Bus,2013,100,217,317,0,
1117,17820,"Colorado Springs, CO Metro Area",Bus,2014,302,163,465,0,
1118,17820,"Colorado Springs, CO Metro Area",Bus,2015,217,114,331,0,
1119,17820,"Colorado Springs, CO Metro Area",Bus,2016,268,257,525,0,
1120,17820,"Colorado Springs, CO Metro Area",Bus,2017,326,187,513,0,
1121,17820,"Colorado Springs, CO Metro Area",Bus,2018,55,397,452,0,
1122,17860,"Columbia, MO Metro Area",Bus,2002,10,14,24,0,
1123,17860,"Columbia, MO Metro Area",Bus,2003,2,17,19,0,
1124,17860,"Columbia, MO Metro Area",Bus,2004,5,0,5,0,
1125,17860,"Columbia, MO Metro Area",Bus,2005,21,0,21,0,
1126,17860,"Columbia, MO Metro Area",Bus,2006,28,0,28,0,
1127,17860,"Columbia, MO Metro Area",Bus,2007,17,0,17,0,
1128,17860,"Columbia, MO Metro Area",Bus,2008,22,133,155,0,
1129,17860,"Columbia, MO Metro Area",Bus,2009,26,183,209,0,
1130,17860,"Columbia, MO Metro Area",Bus,2010,22,1,23,0,
1131,17860,"Columbia, MO Metro Area",Bus,2011,16,3,19,0,
1132,17860,"Columbia, MO Metro Area",Bus,2012,48,30,78,0,
1133,17860,"Columbia, MO Metro Area",Bus,2013,71,71,142,0,
1134,17860,"Columbia, MO Metro Area",Bus,2014,247,20,267,0,
1135,17860,"Columbia, MO Metro Area",Bus,2015,212,58,270,0,
1136,17860,"Columbia, MO Metro Area",Bus,2016,160,3,163,0,
1137,17860,"Columbia, MO Metro Area",Bus,2017,150,3,153,0,
1138,17860,"Columbia, MO Metro Area",Bus,2018,63,308,371,0,
1139,17900,"Columbia, SC Metro Area",Bus,2002,0,0,0,1,Not reported
1140,17900,"Columbia, SC Metro Area",Bus,2003,0,0,0,1,Not reported
1141,17900,"Columbia, SC Metro Area",Bus,2004,0,0,0,1,Not reported
1142,17900,"Columbia, SC Metro Area",Bus,2005,0,0,0,1,Not reported
1143,17900,"Columbia, SC Metro Area",Bus,2006,0,0,0,1,Not reported
1144,17900,"Columbia, SC Metro Area",Bus,2007,0,0,0,1,Not reported
1145,17900,"Columbia, SC Metro Area",Bus,2008,49,273,322,0,
1146,17900,"Columbia, SC Metro Area",Bus,2009,124,104,228,0,
1147,17900,"Columbia, SC Metro Area",Bus,2010,300,71,371,0,
1148,17900,"Columbia, SC Metro Area",Bus,2011,103,77,180,0,
1149,17900,"Columbia, SC Metro Area",Bus,2012,10,73,83,0,
1150,17900,"Columbia, SC Metro Area",Bus,2013,114,50,164,0,
1151,17900,"Columbia, SC Metro Area",Bus,2014,136,86,222,0,
1152,17900,"Columbia, SC Metro Area",Bus,2015,98,47,145,0,
1153,17900,"Columbia, SC Metro Area",Bus,2016,289,24,313,0,
1154,17900,"Columbia, SC Metro Area",Bus,2017,377,356,733,0,
1155,17900,"Columbia, SC Metro Area",Bus,2018,413,198,611,0,
1156,18140,"Columbus, OH Metro Area",Bus,2002,1786,630,2416,0,
1157,18140,"Columbus, OH Metro Area",Bus,2003,1937,678,2615,0,
1158,18140,"Columbus, OH Metro Area",Bus,2004,1782,556,2338,0,
1159,18140,"Columbus, OH Metro Area",Bus,2005,1472,425,1897,0,
1160,18140,"Columbus, OH Metro Area",Bus,2006,1244,377,1621,0,
1161,18140,"Columbus, OH Metro Area",Bus,2007,1394,504,1898,0,
1162,18140,"Columbus, OH Metro Area",Bus,2008,1453,455,1908,0,
1163,18140,"Columbus, OH Metro Area",Bus,2009,1121,424,1545,0,
1164,18140,"Columbus, OH Metro Area",Bus,2010,2404,1452,3856,0,
1165,18140,"Columbus, OH Metro Area",Bus,2011,2070,1381,3451,0,
1166,18140,"Columbus, OH Metro Area",Bus,2012,2024,1351,3375,0,
1167,18140,"Columbus, OH Metro Area",Bus,2013,2049,1221,3270,0,
1168,18140,"Columbus, OH Metro Area",Bus,2014,2118,1211,3329,0,
1169,18140,"Columbus, OH Metro Area",Bus,2015,2154,1236,3390,0,
1170,18140,"Columbus, OH Metro Area",Bus,2016,2316,1565,3881,0,
1171,18140,"Columbus, OH Metro Area",Bus,2017,2067,1093,3160,0,
1172,18140,"Columbus, OH Metro Area",Bus,2018,2814,1260,4074,0,
1207,18580,"Corpus Christi, TX Metro Area",Bus,2002,139,172,311,0,
1208,18580,"Corpus Christi, TX Metro Area",Bus,2003,199,97,296,0,
1209,18580,"Corpus Christi, TX Metro Area",Bus,2004,134,163,297,0,
1210,18580,"Corpus Christi, TX Metro Area",Bus,2005,111,288,399,0,
1211,18580,"Corpus Christi, TX Metro Area",Bus,2006,784,633,1417,0,
1212,18580,"Corpus Christi, TX Metro Area",Bus,2007,752,598,1350,0,
1213,18580,"Corpus Christi, TX Metro Area",Bus,2008,523,731,1254,0,
1214,18580,"Corpus Christi, TX Metro Area",Bus,2009,238,642,880,0,
1215,18580,"Corpus Christi, TX Metro Area",Bus,2010,422,448,870,0,
1216,18580,"Corpus Christi, TX Metro Area",Bus,2011,109,653,762,0,
1217,18580,"Corpus Christi, TX Metro Area",Bus,2012,92,485,577,0,
1218,18580,"Corpus Christi, TX Metro Area",Bus,2013,47,482,529,0,
1219,18580,"Corpus Christi, TX Metro Area",Bus,2014,98,401,499,0,
1220,18580,"Corpus Christi, TX Metro Area",Bus,2015,228,219,447,0,
1221,18580,"Corpus Christi, TX Metro Area",Bus,2016,240,164,404,0,
1222,18580,"Corpus Christi, TX Metro Area",Bus,2017,158,124,282,0,
1223,18580,"Corpus Christi, TX Metro Area",Bus,2018,112,83,195,0,
1224,18700,"Corvallis, OR Metro Area",Bus,2002,0,0,0,1,Not reported
1225,18700,"Corvallis, OR Metro Area",Bus,2003,0,0,0,1,Not reported
1226,18700,"Corvallis, OR Metro Area",Bus,2004,0,0,0,1,Not reported
1227,18700,"Corvallis, OR Metro Area",Bus,2005,0,0,0,1,Not reported
1228,18700,"Corvallis, OR Metro Area",Bus,2006,0,0,0,1,Not reported
1229,18700,"Corvallis, OR Metro Area",Bus,2007,0,0,0,1,Not reported
1230,18700,"Corvallis, OR Metro Area",Bus,2008,0,0,0,1,Not reported
1231,18700,"Corvallis, OR Metro Area",Bus,2009,27,7,34,0,
1232,18700,"Corvallis, OR Metro Area",Bus,2010,27,22,49,0,
1233,18700,"Corvallis, OR Metro Area",Bus,2011,28,8,36,0,
1234,18700,"Corvallis, OR Metro Area",Bus,2012,36,11,47,0,
1235,18700,"Corvallis, OR Metro Area",Bus,2013,20,8,28,0,
1236,18700,"Corvallis, OR Metro Area",Bus,2014,22,10,32,0,
1237,18700,"Corvallis, OR Metro Area",Bus,2015,23,9,32,0,
1238,18700,"Corvallis, OR Metro Area",Bus,2016,16,10,26,0,
1239,18700,"Corvallis, OR Metro Area",Bus,2017,19,11,30,0,
1240,18700,"Corvallis, OR Metro Area",Bus,2018,17,12,29,0,
1802,18880,"Crestview-Fort Walton Beach-Destin, FL Metro Area",Bus,2002,0,0,0,1,Not reported
1804,18880,"Crestview-Fort Walton Beach-Destin, FL Metro Area",Bus,2003,0,0,0,1,Not reported
1806,18880,"Crestview-Fort Walton Beach-Destin, FL Metro Area",Bus,2004,0,0,0,1,Not reported
1808,18880,"Crestview-Fort Walton Beach-Destin, FL Metro Area",Bus,2005,0,0,0,1,Not reported
1810,18880,"Crestview-Fort Walton Beach-Destin, FL Metro Area",Bus,2006,0,0,0,1,Not reported
1812,18880,"Crestview-Fort Walton Beach-Destin, FL Metro Area",Bus,2007,0,0,0,1,Not reported
1814,18880,"Crestview-Fort Walton Beach-Destin, FL Metro Area",Bus,2008,0,0,0,1,Not reported
1816,18880,"Crestview-Fort Walton Beach-Destin, FL Metro Area",Bus,2009,13,2,15,0,
1818,18880,"Crestview-Fort Walton Beach-Destin, FL Metro Area",Bus,2010,7,5,12,0,
1820,18880,"Crestview-Fort Walton Beach-Destin, FL Metro Area",Bus,2011,5,5,10,0,
1822,18880,"Crestview-Fort Walton Beach-Destin, FL Metro Area",Bus,2012,11,4,15,0,
1824,18880,"Crestview-Fort Walton Beach-Destin, FL Metro Area",Bus,2013,19,0,19,0,
1826,18880,"Crestview-Fort Walton Beach-Destin, FL Metro Area",Bus,2014,4,5,9,0,
1828,18880,"Crestview-Fort Walton Beach-Destin, FL Metro Area",Bus,2015,17,6,23,0,
1830,18880,"Crestview-Fort Walton Beach-Destin, FL Metro Area",Bus,2016,15,9,24,0,
1832,18880,"Crestview-Fort Walton Beach-Destin, FL Metro Area",Bus,2017,13,14,27,0,
1834,18880,"Crestview-Fort Walton Beach-Destin, FL Metro Area",Bus,2018,20,17,37,0,
1241,19100,"Dallas-Fort Worth-Arlington, TX Metro Area",Bus,2002,3364,3804,7168,0,
1360,19100,"Dallas-Fort Worth-Arlington, TX Metro Area",Bus,2002,0,0,0,0,
1242,19100,"Dallas-Fort Worth-Arlington, TX Metro Area",Bus,2003,2667,3302,5969,0,
1361,19100,"Dallas-Fort Worth-Arlington, TX Metro Area",Bus,2003,0,0,0,0,
1243,19100,"Dallas-Fort Worth-Arlington, TX Metro Area",Bus,2004,3751,3729,7480,0,
1362,19100,"Dallas-Fort Worth-Arlington, TX Metro Area",Bus,2004,0,0,0,0,
1244,19100,"Dallas-Fort Worth-Arlington, TX Metro Area",Bus,2005,3888,3455,7343,0,
1363,19100,"Dallas-Fort Worth-Arlington, TX Metro Area",Bus,2005,0,0,0,0,
1245,19100,"Dallas-Fort Worth-Arlington, TX Metro Area",Bus,2006,3877,2840,6717,0,
1364,19100,"Dallas-Fort Worth-Arlington, TX Metro Area",Bus,2006,0,0,0,0,
1246,19100,"Dallas-Fort Worth-Arlington, TX Metro Area",Bus,2007,4171,2986,7157,0,
1365,19100,"Dallas-Fort Worth-Arlington, TX Metro Area",Bus,2007,118,7,125,0,
1247,19100,"Dallas-Fort Worth-Arlington, TX Metro Area",Bus,2008,3575,2752,6327,0,
1366,19100,"Dallas-Fort Worth-Arlington, TX Metro Area",Bus,2008,15,246,261,0,
1248,19100,"Dallas-Fort Worth-Arlington, TX Metro Area",Bus,2009,3397,2441,5838,0,
1367,19100,"Dallas-Fort Worth-Arlington, TX Metro Area",Bus,2009,10,192,202,0,
1249,19100,"Dallas-Fort Worth-Arlington, TX Metro Area",Bus,2010,3490,2407,5897,0,
1368,19100,"Dallas-Fort Worth-Arlington, TX Metro Area",Bus,2010,32,247,279,0,
1250,19100,"Dallas-Fort Worth-Arlington, TX Metro Area",Bus,2011,3776,3175,6951,0,
1369,19100,"Dallas-Fort Worth-Arlington, TX Metro Area",Bus,2011,209,18,227,0,
1251,19100,"Dallas-Fort Worth-Arlington, TX Metro Area",Bus,2012,3703,2726,6429,0,
1370,19100,"Dallas-Fort Worth-Arlington, TX Metro Area",Bus,2012,126,25,151,0,
1252,19100,"Dallas-Fort Worth-Arlington, TX Metro Area",Bus,2013,3764,2515,6279,0,
1371,19100,"Dallas-Fort Worth-Arlington, TX Metro Area",Bus,2013,128,15,143,0,
1253,19100,"Dallas-Fort Worth-Arlington, TX Metro Area",Bus,2014,2963,2012,4975,0,
1372,19100,"Dallas-Fort Worth-Arlington, TX Metro Area",Bus,2014,253,13,266,0,
1254,19100,"Dallas-Fort Worth-Arlington, TX Metro Area",Bus,2015,2374,1859,4233,0,
1373,19100,"Dallas-Fort Worth-Arlington, TX Metro Area",Bus,2015,216,28,244,0,
1255,19100,"Dallas-Fort Worth-Arlington, TX Metro Area",Bus,2016,2520,1967,4487,0,
1374,19100,"Dallas-Fort Worth-Arlington, TX Metro Area",Bus,2016,248,57,305,0,
1256,19100,"Dallas-Fort Worth-Arlington, TX Metro Area",Bus,2017,2375,1943,4318,0,
1375,19100,"Dallas-Fort Worth-Arlington, TX Metro Area",Bus,2017,153,18,171,0,
1257,19100,"Dallas-Fort Worth-Arlington, TX Metro Area",Bus,2018,2585,2596,5181,0,
1376,19100,"Dallas-Fort Worth-Arlington, TX Metro Area",Bus,2018,314,73,387,0,
1258,19100,"Dallas-Fort Worth-Arlington, TX Metro Area",Rail,2002,32,7,39,0,
1377,19100,"Dallas-Fort Worth-Arlington, TX Metro Area",Rail,2002,0,0,0,0,
1259,19100,"Dallas-Fort Worth-Arlington, TX Metro Area",Rail,2003,40,22,62,0,
1378,19100,"Dallas-Fort Worth-Arlington, TX Metro Area",Rail,2003,0,0,0,0,
1260,19100,"Dallas-Fort Worth-Arlington, TX Metro Area",Rail,2004,92,43,135,0,
1379,19100,"Dallas-Fort Worth-Arlington, TX Metro Area",Rail,2004,0,0,0,0,
1261,19100,"Dallas-Fort Worth-Arlington, TX Metro Area",Rail,2005,115,38,153,0,
1380,19100,"Dallas-Fort Worth-Arlington, TX Metro Area",Rail,2005,0,0,0,0,
1262,19100,"Dallas-Fort Worth-Arlington, TX Metro Area",Rail,2006,89,36,125,0,
1381,19100,"Dallas-Fort Worth-Arlington, TX Metro Area",Rail,2006,0,0,0,0,
1263,19100,"Dallas-Fort Worth-Arlington, TX Metro Area",Rail,2007,89,36,125,0,
1382,19100,"Dallas-Fort Worth-Arlington, TX Metro Area",Rail,2007,0,0,0,0,
1264,19100,"Dallas-Fort Worth-Arlington, TX Metro Area",Rail,2008,129,50,179,0,
1383,19100,"Dallas-Fort Worth-Arlington, TX Metro Area",Rail,2008,0,0,0,0,
1265,19100,"Dallas-Fort Worth-Arlington, TX Metro Area",Rail,2009,196,87,283,0,
1384,19100,"Dallas-Fort Worth-Arlington, TX Metro Area",Rail,2009,0,0,0,0,
1266,19100,"Dallas-Fort Worth-Arlington, TX Metro Area",Rail,2010,192,110,302,0,
1385,19100,"Dallas-Fort Worth-Arlington, TX Metro Area",Rail,2010,0,0,0,0,
1267,19100,"Dallas-Fort Worth-Arlington, TX Metro Area",Rail,2011,241,162,403,0,
1386,19100,"Dallas-Fort Worth-Arlington, TX Metro Area",Rail,2011,0,0,0,0,
1268,19100,"Dallas-Fort Worth-Arlington, TX Metro Area",Rail,2012,149,127,276,0,
1387,19100,"Dallas-Fort Worth-Arlington, TX Metro Area",Rail,2012,0,0,0,0,
1269,19100,"Dallas-Fort Worth-Arlington, TX Metro Area",Rail,2013,180,105,285,0,
1388,19100,"Dallas-Fort Worth-Arlington, TX Metro Area",Rail,2013,3,0,3,0,
1270,19100,"Dallas-Fort Worth-Arlington, TX Metro Area",Rail,2014,111,111,222,0,
1389,19100,"Dallas-Fort Worth-Arlington, TX Metro Area",Rail,2014,2,0,2,0,
1271,19100,"Dallas-Fort Worth-Arlington, TX Metro Area",Rail,2015,113,197,310,0,
1390,19100,"Dallas-Fort Worth-Arlington, TX Metro Area",Rail,2015,2,0,2,0,
1272,19100,"Dallas-Fort Worth-Arlington, TX Metro Area",Rail,2016,125,225,350,0,
1391,19100,"Dallas-Fort Worth-Arlington, TX Metro Area",Rail,2016,2,0,2,0,
1273,19100,"Dallas-Fort Worth-Arlington, TX Metro Area",Rail,2017,308,240,548,0,
1392,19100,"Dallas-Fort Worth-Arlington, TX Metro Area",Rail,2017,11,0,11,0,
1274,19100,"Dallas-Fort Worth-Arlington, TX Metro Area",Rail,2018,227,89,316,0,
1393,19100,"Dallas-Fort Worth-Arlington, TX Metro Area",Rail,2018,3,0,3,0,
1292,19340,"Davenport-Moline-Rock Island, IA-IL Metro Area",Bus,2002,108,161,269,0,
1293,19340,"Davenport-Moline-Rock Island, IA-IL Metro Area",Bus,2003,236,120,356,0,
1294,19340,"Davenport-Moline-Rock Island, IA-IL Metro Area",Bus,2004,107,97,204,0,
1295,19340,"Davenport-Moline-Rock Island, IA-IL Metro Area",Bus,2005,104,105,209,0,
1296,19340,"Davenport-Moline-Rock Island, IA-IL Metro Area",Bus,2006,86,114,200,0,
1297,19340,"Davenport-Moline-Rock Island, IA-IL Metro Area",Bus,2007,197,25,222,0,
1298,19340,"Davenport-Moline-Rock Island, IA-IL Metro Area",Bus,2008,147,8,155,0,
1299,19340,"Davenport-Moline-Rock Island, IA-IL Metro Area",Bus,2009,277,23,300,0,
1300,19340,"Davenport-Moline-Rock Island, IA-IL Metro Area",Bus,2010,201,39,240,0,
1301,19340,"Davenport-Moline-Rock Island, IA-IL Metro Area",Bus,2011,160,54,214,0,
1302,19340,"Davenport-Moline-Rock Island, IA-IL Metro Area",Bus,2012,156,60,216,0,
1303,19340,"Davenport-Moline-Rock Island, IA-IL Metro Area",Bus,2013,260,165,425,0,
1304,19340,"Davenport-Moline-Rock Island, IA-IL Metro Area",Bus,2014,378,219,597,0,
1305,19340,"Davenport-Moline-Rock Island, IA-IL Metro Area",Bus,2015,140,112,252,0,
1306,19340,"Davenport-Moline-Rock Island, IA-IL Metro Area",Bus,2016,277,228,505,0,
1307,19340,"Davenport-Moline-Rock Island, IA-IL Metro Area",Bus,2017,288,130,418,0,
1308,19340,"Davenport-Moline-Rock Island, IA-IL Metro Area",Bus,2018,407,90,497,0,
1326,19380,"Dayton, OH Metro Area",Bus,2002,3133,3192,6325,0,
1327,19380,"Dayton, OH Metro Area",Bus,2003,2350,2021,4371,0,
1328,19380,"Dayton, OH Metro Area",Bus,2004,2308,1251,3559,0,
1329,19380,"Dayton, OH Metro Area",Bus,2005,2923,1989,4912,0,
1330,19380,"Dayton, OH Metro Area",Bus,2006,2861,1481,4342,0,
1331,19380,"Dayton, OH Metro Area",Bus,2007,2712,1619,4331,0,
1332,19380,"Dayton, OH Metro Area",Bus,2008,3292,1667,4959,0,
1333,19380,"Dayton, OH Metro Area",Bus,2009,1727,1374,3101,0,
1334,19380,"Dayton, OH Metro Area",Bus,2010,1524,1354,2878,0,
1335,19380,"Dayton, OH Metro Area",Bus,2011,1129,1033,2162,0,
1336,19380,"Dayton, OH Metro Area",Bus,2012,1367,1153,2520,0,
1337,19380,"Dayton, OH Metro Area",Bus,2013,1790,1019,2809,0,
1338,19380,"Dayton, OH Metro Area",Bus,2014,1851,504,2355,0,
1339,19380,"Dayton, OH Metro Area",Bus,2015,3478,185,3663,0,
1340,19380,"Dayton, OH Metro Area",Bus,2016,5134,249,5383,0,
1341,19380,"Dayton, OH Metro Area",Bus,2017,2169,3124,5293,0,
1342,19380,"Dayton, OH Metro Area",Bus,2018,2592,2134,4726,0,
1343,19500,"Decatur, IL Metro Area",Bus,2002,202,15,217,0,
1344,19500,"Decatur, IL Metro Area",Bus,2003,73,3,76,1,Inconsistent
1345,19500,"Decatur, IL Metro Area",Bus,2004,36,10,46,1,Inconsistent
1346,19500,"Decatur, IL Metro Area",Bus,2005,47,13,60,1,Inconsistent
1347,19500,"Decatur, IL Metro Area",Bus,2006,69,12,81,1,Inconsistent
1348,19500,"Decatur, IL Metro Area",Bus,2007,299,26,325,0,
1349,19500,"Decatur, IL Metro Area",Bus,2008,450,48,498,0,
1350,19500,"Decatur, IL Metro Area",Bus,2009,212,198,410,0,
1351,19500,"Decatur, IL Metro Area",Bus,2010,241,138,379,0,
1352,19500,"Decatur, IL Metro Area",Bus,2011,160,51,211,0,
1353,19500,"Decatur, IL Metro Area",Bus,2012,227,109,336,0,
1354,19500,"Decatur, IL Metro Area",Bus,2013,334,56,390,0,
1355,19500,"Decatur, IL Metro Area",Bus,2014,188,38,226,0,
1356,19500,"Decatur, IL Metro Area",Bus,2015,189,95,284,0,
1357,19500,"Decatur, IL Metro Area",Bus,2016,163,72,235,0,
1358,19500,"Decatur, IL Metro Area",Bus,2017,185,96,281,0,
1359,19500,"Decatur, IL Metro Area",Bus,2018,181,72,253,0,
3655,19660,"Deltona-Daytona Beach-Ormond Beach, FL Metro Area",Bus,2002,15,2,17,1,Inconsistent
3657,19660,"Deltona-Daytona Beach-Ormond Beach, FL Metro Area",Bus,2003,26,3,29,1,Inconsistent
3659,19660,"Deltona-Daytona Beach-Ormond Beach, FL Metro Area",Bus,2004,173,122,295,0,
3661,19660,"Deltona-Daytona Beach-Ormond Beach, FL Metro Area",Bus,2005,271,77,348,0,
3663,19660,"Deltona-Daytona Beach-Ormond Beach, FL Metro Area",Bus,2006,427,116,543,0,
3665,19660,"Deltona-Daytona Beach-Ormond Beach, FL Metro Area",Bus,2007,417,245,662,0,
3667,19660,"Deltona-Daytona Beach-Ormond Beach, FL Metro Area",Bus,2008,419,167,586,0,
3669,19660,"Deltona-Daytona Beach-Ormond Beach, FL Metro Area",Bus,2009,453,207,660,0,
3671,19660,"Deltona-Daytona Beach-Ormond Beach, FL Metro Area",Bus,2010,296,424,720,0,
3673,19660,"Deltona-Daytona Beach-Ormond Beach, FL Metro Area",Bus,2011,370,182,552,0,
3675,19660,"Deltona-Daytona Beach-Ormond Beach, FL Metro Area",Bus,2012,383,126,509,0,
3677,19660,"Deltona-Daytona Beach-Ormond Beach, FL Metro Area",Bus,2013,469,93,562,0,
3679,19660,"Deltona-Daytona Beach-Ormond Beach, FL Metro Area",Bus,2014,179,400,579,0,
3681,19660,"Deltona-Daytona Beach-Ormond Beach, FL Metro Area",Bus,2015,175,428,603,0,
3683,19660,"Deltona-Daytona Beach-Ormond Beach, FL Metro Area",Bus,2016,302,181,483,0,
3685,19660,"Deltona-Daytona Beach-Ormond Beach, FL Metro Area",Bus,2017,329,90,419,0,
3687,19660,"Deltona-Daytona Beach-Ormond Beach, FL Metro Area",Bus,2018,398,130,528,0,
1394,19740,"Denver-Aurora-Broomfield, CO Metro Area",Bus,2002,1155,502,1657,0,
1395,19740,"Denver-Aurora-Broomfield, CO Metro Area",Bus,2003,696,402,1098,0,
1396,19740,"Denver-Aurora-Broomfield, CO Metro Area",Bus,2004,665,516,1181,0,
1397,19740,"Denver-Aurora-Broomfield, CO Metro Area",Bus,2005,696,474,1170,0,
1398,19740,"Denver-Aurora-Broomfield, CO Metro Area",Bus,2006,668,400,1068,0,
1399,19740,"Denver-Aurora-Broomfield, CO Metro Area",Bus,2007,734,450,1184,0,
1400,19740,"Denver-Aurora-Broomfield, CO Metro Area",Bus,2008,1194,865,2059,0,
1401,19740,"Denver-Aurora-Broomfield, CO Metro Area",Bus,2009,992,535,1527,0,
1402,19740,"Denver-Aurora-Broomfield, CO Metro Area",Bus,2010,1117,609,1726,0,
1403,19740,"Denver-Aurora-Broomfield, CO Metro Area",Bus,2011,1028,882,1910,0,
1404,19740,"Denver-Aurora-Broomfield, CO Metro Area",Bus,2012,1064,1312,2376,0,
1405,19740,"Denver-Aurora-Broomfield, CO Metro Area",Bus,2013,993,1226,2219,0,
1406,19740,"Denver-Aurora-Broomfield, CO Metro Area",Bus,2014,1005,1221,2226,0,
1407,19740,"Denver-Aurora-Broomfield, CO Metro Area",Bus,2015,627,593,1220,0,
1408,19740,"Denver-Aurora-Broomfield, CO Metro Area",Bus,2016,679,775,1454,0,
1409,19740,"Denver-Aurora-Broomfield, CO Metro Area",Bus,2017,644,926,1570,0,
1410,19740,"Denver-Aurora-Broomfield, CO Metro Area",Bus,2018,710,1507,2217,0,
1411,19740,"Denver-Aurora-Broomfield, CO Metro Area",Rail,2002,0,0,0,1,Under-reported
1412,19740,"Denver-Aurora-Broomfield, CO Metro Area",Rail,2003,0,0,0,1,Under-reported
1413,19740,"Denver-Aurora-Broomfield, CO Metro Area",Rail,2004,1,2,3,1,Under-reported
1414,19740,"Denver-Aurora-Broomfield, CO Metro Area",Rail,2005,1,2,3,1,Under-reported
1415,19740,"Denver-Aurora-Broomfield, CO Metro Area",Rail,2006,0,0,0,1,Under-reported
1416,19740,"Denver-Aurora-Broomfield, CO Metro Area",Rail,2007,7,11,18,1,Under-reported
1417,19740,"Denver-Aurora-Broomfield, CO Metro Area",Rail,2008,296,83,379,0,
1418,19740,"Denver-Aurora-Broomfield, CO Metro Area",Rail,2009,52,273,325,0,
1419,19740,"Denver-Aurora-Broomfield, CO Metro Area",Rail,2010,85,359,444,0,
1420,19740,"Denver-Aurora-Broomfield, CO Metro Area",Rail,2011,92,295,387,0,
1421,19740,"Denver-Aurora-Broomfield, CO Metro Area",Rail,2012,191,193,384,0,
1422,19740,"Denver-Aurora-Broomfield, CO Metro Area",Rail,2013,252,135,387,0,
1423,19740,"Denver-Aurora-Broomfield, CO Metro Area",Rail,2014,278,158,436,0,
1424,19740,"Denver-Aurora-Broomfield, CO Metro Area",Rail,2015,303,174,477,0,
1425,19740,"Denver-Aurora-Broomfield, CO Metro Area",Rail,2016,330,171,501,0,
1426,19740,"Denver-Aurora-Broomfield, CO Metro Area",Rail,2017,355,426,781,0,
1427,19740,"Denver-Aurora-Broomfield, CO Metro Area",Rail,2018,383,450,833,0,
1428,19780,"Des Moines-West Des Moines, IA Metro Area",Bus,2002,136,360,496,0,
1429,19780,"Des Moines-West Des Moines, IA Metro Area",Bus,2003,272,142,414,0,
1430,19780,"Des Moines-West Des Moines, IA Metro Area",Bus,2004,380,88,468,0,
1431,19780,"Des Moines-West Des Moines, IA Metro Area",Bus,2005,443,18,461,0,
1432,19780,"Des Moines-West Des Moines, IA Metro Area",Bus,2006,445,38,483,0,
1433,19780,"Des Moines-West Des Moines, IA Metro Area",Bus,2007,297,106,403,0,
1434,19780,"Des Moines-West Des Moines, IA Metro Area",Bus,2008,402,180,582,0,
1435,19780,"Des Moines-West Des Moines, IA Metro Area",Bus,2009,436,108,544,0,
1436,19780,"Des Moines-West Des Moines, IA Metro Area",Bus,2010,335,118,453,0,
1437,19780,"Des Moines-West Des Moines, IA Metro Area",Bus,2011,379,88,467,0,
1438,19780,"Des Moines-West Des Moines, IA Metro Area",Bus,2012,456,67,523,0,
1439,19780,"Des Moines-West Des Moines, IA Metro Area",Bus,2013,439,47,486,0,
1440,19780,"Des Moines-West Des Moines, IA Metro Area",Bus,2014,442,84,526,0,
1441,19780,"Des Moines-West Des Moines, IA Metro Area",Bus,2015,542,81,623,0,
1442,19780,"Des Moines-West Des Moines, IA Metro Area",Bus,2016,324,480,804,0,
1443,19780,"Des Moines-West Des Moines, IA Metro Area",Bus,2017,699,532,1231,0,
1444,19780,"Des Moines-West Des Moines, IA Metro Area",Bus,2018,497,255,752,0,
154,19820,"Detroit-Warren-Livonia, MI Metro Area",Bus,2002,663,241,904,0,
1445,19820,"Detroit-Warren-Livonia, MI Metro Area",Bus,2002,5796,2446,8242,0,
3859,19820,"Detroit-Warren-Livonia, MI Metro Area",Bus,2002,1,3,4,0,
156,19820,"Detroit-Warren-Livonia, MI Metro Area",Bus,2003,587,407,994,0,
1446,19820,"Detroit-Warren-Livonia, MI Metro Area",Bus,2003,5837,2613,8450,0,
3860,19820,"Detroit-Warren-Livonia, MI Metro Area",Bus,2003,1,3,4,0,
158,19820,"Detroit-Warren-Livonia, MI Metro Area",Bus,2004,465,356,821,0,
1447,19820,"Detroit-Warren-Livonia, MI Metro Area",Bus,2004,13969,3759,17728,0,
3861,19820,"Detroit-Warren-Livonia, MI Metro Area",Bus,2004,0,3,3,0,
160,19820,"Detroit-Warren-Livonia, MI Metro Area",Bus,2005,457,360,817,0,
1448,19820,"Detroit-Warren-Livonia, MI Metro Area",Bus,2005,13900,3405,17305,0,
3862,19820,"Detroit-Warren-Livonia, MI Metro Area",Bus,2005,3,56,59,0,
162,19820,"Detroit-Warren-Livonia, MI Metro Area",Bus,2006,405,452,857,0,
1449,19820,"Detroit-Warren-Livonia, MI Metro Area",Bus,2006,11395,4202,15597,0,
3863,19820,"Detroit-Warren-Livonia, MI Metro Area",Bus,2006,15,47,62,0,
164,19820,"Detroit-Warren-Livonia, MI Metro Area",Bus,2007,450,326,776,0,
1450,19820,"Detroit-Warren-Livonia, MI Metro Area",Bus,2007,5746,4774,10520,0,
3864,19820,"Detroit-Warren-Livonia, MI Metro Area",Bus,2007,17,8,25,0,
166,19820,"Detroit-Warren-Livonia, MI Metro Area",Bus,2008,314,356,670,0,
1451,19820,"Detroit-Warren-Livonia, MI Metro Area",Bus,2008,8254,6651,14905,0,
3865,19820,"Detroit-Warren-Livonia, MI Metro Area",Bus,2008,11,14,25,0,
168,19820,"Detroit-Warren-Livonia, MI Metro Area",Bus,2009,285,371,656,0,
1452,19820,"Detroit-Warren-Livonia, MI Metro Area",Bus,2009,8954,5485,14439,0,
3866,19820,"Detroit-Warren-Livonia, MI Metro Area",Bus,2009,10,7,17,0,
170,19820,"Detroit-Warren-Livonia, MI Metro Area",Bus,2010,324,402,726,0,
1453,19820,"Detroit-Warren-Livonia, MI Metro Area",Bus,2010,5262,3659,8921,0,
3867,19820,"Detroit-Warren-Livonia, MI Metro Area",Bus,2010,12,6,18,0,
172,19820,"Detroit-Warren-Livonia, MI Metro Area",Bus,2011,297,369,666,0,
1454,19820,"Detroit-Warren-Livonia, MI Metro Area",Bus,2011,7445,4046,11491,0,
3868,19820,"Detroit-Warren-Livonia, MI Metro Area",Bus,2011,12,7,19,0,
174,19820,"Detroit-Warren-Livonia, MI Metro Area",Bus,2012,275,370,645,0,
1455,19820,"Detroit-Warren-Livonia, MI Metro Area",Bus,2012,5529,3310,8839,0,
3869,19820,"Detroit-Warren-Livonia, MI Metro Area",Bus,2012,3,9,12,0,
176,19820,"Detroit-Warren-Livonia, MI Metro Area",Bus,2013,323,462,785,0,
1456,19820,"Detroit-Warren-Livonia, MI Metro Area",Bus,2013,4717,2548,7265,0,
3870,19820,"Detroit-Warren-Livonia, MI Metro Area",Bus,2013,9,5,14,0,
178,19820,"Detroit-Warren-Livonia, MI Metro Area",Bus,2014,269,389,658,0,
1457,19820,"Detroit-Warren-Livonia, MI Metro Area",Bus,2014,5801,3814,9615,0,
3871,19820,"Detroit-Warren-Livonia, MI Metro Area",Bus,2014,9,6,15,0,
180,19820,"Detroit-Warren-Livonia, MI Metro Area",Bus,2015,248,389,637,0,
1458,19820,"Detroit-Warren-Livonia, MI Metro Area",Bus,2015,6464,3218,9682,0,
3872,19820,"Detroit-Warren-Livonia, MI Metro Area",Bus,2015,8,2,10,0,
182,19820,"Detroit-Warren-Livonia, MI Metro Area",Bus,2016,171,297,468,0,
1459,19820,"Detroit-Warren-Livonia, MI Metro Area",Bus,2016,2975,2165,5140,0,
3873,19820,"Detroit-Warren-Livonia, MI Metro Area",Bus,2016,4,1,5,0,
184,19820,"Detroit-Warren-Livonia, MI Metro Area",Bus,2017,205,341,546,0,
1460,19820,"Detroit-Warren-Livonia, MI Metro Area",Bus,2017,2980,1641,4621,0,
3874,19820,"Detroit-Warren-Livonia, MI Metro Area",Bus,2017,3,0,3,0,
186,19820,"Detroit-Warren-Livonia, MI Metro Area",Bus,2018,174,311,485,0,
1461,19820,"Detroit-Warren-Livonia, MI Metro Area",Bus,2018,2667,2531,5198,0,
3875,19820,"Detroit-Warren-Livonia, MI Metro Area",Bus,2018,3,2,5,0,
1462,19820,"Detroit-Warren-Livonia, MI Metro Area",Rail,2002,0,0,0,1,Under-reported
1463,19820,"Detroit-Warren-Livonia, MI Metro Area",Rail,2003,6,3,9,1,Under-reported
1464,19820,"Detroit-Warren-Livonia, MI Metro Area",Rail,2004,5,4,9,1,Under-reported
1465,19820,"Detroit-Warren-Livonia, MI Metro Area",Rail,2005,2,4,6,1,Under-reported
1466,19820,"Detroit-Warren-Livonia, MI Metro Area",Rail,2006,0,22,22,1,Under-reported
1467,19820,"Detroit-Warren-Livonia, MI Metro Area",Rail,2007,4,24,28,1,Under-reported
1468,19820,"Detroit-Warren-Livonia, MI Metro Area",Rail,2008,15,59,74,1,Under-reported
1469,19820,"Detroit-Warren-Livonia, MI Metro Area",Rail,2009,12,95,107,1,Under-reported
1470,19820,"Detroit-Warren-Livonia, MI Metro Area",Rail,2010,256,84,340,0,
1471,19820,"Detroit-Warren-Livonia, MI Metro Area",Rail,2011,231,130,361,0,
1472,19820,"Detroit-Warren-Livonia, MI Metro Area",Rail,2012,364,72,436,0,
1473,19820,"Detroit-Warren-Livonia, MI Metro Area",Rail,2013,245,132,377,0,
1474,19820,"Detroit-Warren-Livonia, MI Metro Area",Rail,2014,269,140,409,0,
1475,19820,"Detroit-Warren-Livonia, MI Metro Area",Rail,2015,94,216,310,0,
1476,19820,"Detroit-Warren-Livonia, MI Metro Area",Rail,2016,60,188,248,0,
1477,19820,"Detroit-Warren-Livonia, MI Metro Area",Rail,2017,81,220,301,0,
1478,19820,"Detroit-Warren-Livonia, MI Metro Area",Rail,2018,85,239,324,0,
1479,20260,"Duluth, MN-WI Metro Area",Bus,2002,155,128,283,0,
1480,20260,"Duluth, MN-WI Metro Area",Bus,2003,1,285,286,0,
1481,20260,"Duluth, MN-WI Metro Area",Bus,2004,2,422,424,0,
1482,20260,"Duluth, MN-WI Metro Area",Bus,2005,0,241,241,0,
1483,20260,"Duluth, MN-WI Metro Area",Bus,2006,0,333,333,0,
1484,20260,"Duluth, MN-WI Metro Area",Bus,2007,0,235,235,0,
1485,20260,"Duluth, MN-WI Metro Area",Bus,2008,0,242,242,0,
1486,20260,"Duluth, MN-WI Metro Area",Bus,2009,253,6,259,0,
1487,20260,"Duluth, MN-WI Metro Area",Bus,2010,242,5,247,0,
1488,20260,"Duluth, MN-WI Metro Area",Bus,2011,188,87,275,0,
1489,20260,"Duluth, MN-WI Metro Area",Bus,2012,202,86,288,0,
1490,20260,"Duluth, MN-WI Metro Area",Bus,2013,195,94,289,0,
1491,20260,"Duluth, MN-WI Metro Area",Bus,2014,236,266,502,0,
1492,20260,"Duluth, MN-WI Metro Area",Bus,2015,257,107,364,0,
1493,20260,"Duluth, MN-WI Metro Area",Bus,2016,241,112,353,0,
1494,20260,"Duluth, MN-WI Metro Area",Bus,2017,196,185,381,0,
1495,20260,"Duluth, MN-WI Metro Area",Bus,2018,150,191,341,0,
1496,20500,"Durham-Chapel Hill, NC Metro Area",Bus,2002,230,129,359,0,
1497,20500,"Durham-Chapel Hill, NC Metro Area",Bus,2003,261,116,377,0,
1498,20500,"Durham-Chapel Hill, NC Metro Area",Bus,2004,274,120,394,0,
1499,20500,"Durham-Chapel Hill, NC Metro Area",Bus,2005,300,124,424,0,
1500,20500,"Durham-Chapel Hill, NC Metro Area",Bus,2006,321,86,407,0,
1501,20500,"Durham-Chapel Hill, NC Metro Area",Bus,2007,136,99,235,0,
1502,20500,"Durham-Chapel Hill, NC Metro Area",Bus,2008,287,402,689,0,
1503,20500,"Durham-Chapel Hill, NC Metro Area",Bus,2009,612,158,770,0,
1504,20500,"Durham-Chapel Hill, NC Metro Area",Bus,2010,576,232,808,0,
1505,20500,"Durham-Chapel Hill, NC Metro Area",Bus,2011,659,234,893,0,
1506,20500,"Durham-Chapel Hill, NC Metro Area",Bus,2012,537,260,797,0,
1507,20500,"Durham-Chapel Hill, NC Metro Area",Bus,2013,413,329,742,0,
1508,20500,"Durham-Chapel Hill, NC Metro Area",Bus,2014,345,134,479,0,
1509,20500,"Durham-Chapel Hill, NC Metro Area",Bus,2015,404,431,835,0,
1510,20500,"Durham-Chapel Hill, NC Metro Area",Bus,2016,787,358,1145,0,
1511,20500,"Durham-Chapel Hill, NC Metro Area",Bus,2017,412,437,849,0,
1512,20500,"Durham-Chapel Hill, NC Metro Area",Bus,2018,306,422,728,0,
1530,20740,"Eau Claire, WI Metro Area",Bus,2002,34,287,321,0,
1531,20740,"Eau Claire, WI Metro Area",Bus,2003,17,182,199,0,
1532,20740,"Eau Claire, WI Metro Area",Bus,2004,10,253,263,0,
1533,20740,"Eau Claire, WI Metro Area",Bus,2005,9,120,129,0,
1534,20740,"Eau Claire, WI Metro Area",Bus,2006,13,171,184,0,
1535,20740,"Eau Claire, WI Metro Area",Bus,2007,18,215,233,0,
1536,20740,"Eau Claire, WI Metro Area",Bus,2008,29,249,278,0,
1537,20740,"Eau Claire, WI Metro Area",Bus,2009,18,218,236,0,
1538,20740,"Eau Claire, WI Metro Area",Bus,2010,31,277,308,0,
1539,20740,"Eau Claire, WI Metro Area",Bus,2011,32,189,221,0,
1540,20740,"Eau Claire, WI Metro Area",Bus,2012,33,226,259,0,
1541,20740,"Eau Claire, WI Metro Area",Bus,2013,20,186,206,0,
1542,20740,"Eau Claire, WI Metro Area",Bus,2014,26,142,168,0,
1543,20740,"Eau Claire, WI Metro Area",Bus,2015,27,130,157,0,
1544,20740,"Eau Claire, WI Metro Area",Bus,2016,12,105,117,0,
1545,20740,"Eau Claire, WI Metro Area",Bus,2017,41,134,175,0,
1546,20740,"Eau Claire, WI Metro Area",Bus,2018,88,98,186,0,
1564,20940,"El Centro, CA Metro Area",Bus,2002,0,0,0,1,Not reported
1565,20940,"El Centro, CA Metro Area",Bus,2003,0,0,0,1,Not reported
1566,20940,"El Centro, CA Metro Area",Bus,2004,0,0,0,1,Not reported
1567,20940,"El Centro, CA Metro Area",Bus,2005,0,0,0,1,Not reported
1568,20940,"El Centro, CA Metro Area",Bus,2006,0,0,0,1,Not reported
1569,20940,"El Centro, CA Metro Area",Bus,2007,0,0,0,1,Not reported
1570,20940,"El Centro, CA Metro Area",Bus,2008,0,0,0,1,Not reported
1571,20940,"El Centro, CA Metro Area",Bus,2009,0,0,0,1,Not reported
1572,20940,"El Centro, CA Metro Area",Bus,2010,0,0,0,1,Not reported
1573,20940,"El Centro, CA Metro Area",Bus,2011,35,37,72,0,
1574,20940,"El Centro, CA Metro Area",Bus,2012,37,38,75,0,
1575,20940,"El Centro, CA Metro Area",Bus,2013,17,4,21,0,
1576,20940,"El Centro, CA Metro Area",Bus,2014,3,25,28,0,
1577,20940,"El Centro, CA Metro Area",Bus,2015,20,28,48,0,
1578,20940,"El Centro, CA Metro Area",Bus,2016,12,10,22,0,
1579,20940,"El Centro, CA Metro Area",Bus,2017,14,4,18,0,
1580,20940,"El Centro, CA Metro Area",Bus,2018,16,7,23,0,
1615,21060,"Elizabethtown, KY Metro Area",Bus,2002,0,0,0,0,
1616,21060,"Elizabethtown, KY Metro Area",Bus,2003,0,0,0,0,
1617,21060,"Elizabethtown, KY Metro Area",Bus,2004,0,0,0,0,
1618,21060,"Elizabethtown, KY Metro Area",Bus,2005,0,0,0,0,
1619,21060,"Elizabethtown, KY Metro Area",Bus,2006,0,0,0,0,
1620,21060,"Elizabethtown, KY Metro Area",Bus,2007,0,0,0,0,
1621,21060,"Elizabethtown, KY Metro Area",Bus,2008,0,0,0,0,
1622,21060,"Elizabethtown, KY Metro Area",Bus,2009,0,0,0,0,
1623,21060,"Elizabethtown, KY Metro Area",Bus,2010,0,0,0,0,
1624,21060,"Elizabethtown, KY Metro Area",Bus,2011,0,0,0,0,
1625,21060,"Elizabethtown, KY Metro Area",Bus,2012,0,0,0,0,
1626,21060,"Elizabethtown, KY Metro Area",Bus,2013,0,0,0,0,
1627,21060,"Elizabethtown, KY Metro Area",Bus,2014,0,0,0,0,
1628,21060,"Elizabethtown, KY Metro Area",Bus,2015,1,0,1,0,
1629,21060,"Elizabethtown, KY Metro Area",Bus,2016,0,0,0,0,
1630,21060,"Elizabethtown, KY Metro Area",Bus,2017,1,0,1,0,
1631,21060,"Elizabethtown, KY Metro Area",Bus,2018,1,0,1,0,
1632,21140,"Elkhart-Goshen, IN Metro Area",Bus,2002,0,0,0,0,
1633,21140,"Elkhart-Goshen, IN Metro Area",Bus,2003,0,0,0,0,
1634,21140,"Elkhart-Goshen, IN Metro Area",Bus,2004,0,0,0,0,
1635,21140,"Elkhart-Goshen, IN Metro Area",Bus,2005,0,0,0,0,
1636,21140,"Elkhart-Goshen, IN Metro Area",Bus,2006,0,0,0,0,
1637,21140,"Elkhart-Goshen, IN Metro Area",Bus,2007,0,0,0,0,
1638,21140,"Elkhart-Goshen, IN Metro Area",Bus,2008,10,0,10,0,
1639,21140,"Elkhart-Goshen, IN Metro Area",Bus,2009,0,8,8,0,
1640,21140,"Elkhart-Goshen, IN Metro Area",Bus,2010,2,0,2,0,
1641,21140,"Elkhart-Goshen, IN Metro Area",Bus,2011,3,1,4,0,
1642,21140,"Elkhart-Goshen, IN Metro Area",Bus,2012,13,2,15,0,
1643,21140,"Elkhart-Goshen, IN Metro Area",Bus,2013,3,16,19,0,
1644,21140,"Elkhart-Goshen, IN Metro Area",Bus,2014,5,15,20,0,
1645,21140,"Elkhart-Goshen, IN Metro Area",Bus,2015,5,12,17,0,
1646,21140,"Elkhart-Goshen, IN Metro Area",Bus,2016,10,10,20,0,
1647,21140,"Elkhart-Goshen, IN Metro Area",Bus,2017,12,8,20,0,
1648,21140,"Elkhart-Goshen, IN Metro Area",Bus,2018,25,7,32,0,
1581,21340,"El Paso, TX Metro Area",Bus,2002,2823,1284,4107,0,
1582,21340,"El Paso, TX Metro Area",Bus,2003,2106,1088,3194,0,
1583,21340,"El Paso, TX Metro Area",Bus,2004,2342,1041,3383,0,
1584,21340,"El Paso, TX Metro Area",Bus,2005,2150,2250,4400,0,
1585,21340,"El Paso, TX Metro Area",Bus,2006,2059,402,2461,0,
1586,21340,"El Paso, TX Metro Area",Bus,2007,1406,272,1678,0,
1587,21340,"El Paso, TX Metro Area",Bus,2008,1440,166,1606,0,
1588,21340,"El Paso, TX Metro Area",Bus,2009,894,82,976,0,
1589,21340,"El Paso, TX Metro Area",Bus,2010,536,53,589,0,
1590,21340,"El Paso, TX Metro Area",Bus,2011,536,53,589,0,
1591,21340,"El Paso, TX Metro Area",Bus,2012,217,26,243,0,
1592,21340,"El Paso, TX Metro Area",Bus,2013,207,59,266,0,
1593,21340,"El Paso, TX Metro Area",Bus,2014,150,6,156,0,
1594,21340,"El Paso, TX Metro Area",Bus,2015,87,4,91,0,
1595,21340,"El Paso, TX Metro Area",Bus,2016,74,9,83,0,
1596,21340,"El Paso, TX Metro Area",Bus,2017,89,12,101,0,
1597,21340,"El Paso, TX Metro Area",Bus,2018,60,22,82,0,
1598,21340,"El Paso, TX Metro Area",Rail,2002,0,0,0,0,
1599,21340,"El Paso, TX Metro Area",Rail,2003,0,0,0,0,
1600,21340,"El Paso, TX Metro Area",Rail,2004,0,0,0,0,
1601,21340,"El Paso, TX Metro Area",Rail,2005,0,0,0,0,
1602,21340,"El Paso, TX Metro Area",Rail,2006,0,0,0,0,
1603,21340,"El Paso, TX Metro Area",Rail,2007,0,0,0,0,
1604,21340,"El Paso, TX Metro Area",Rail,2008,0,0,0,0,
1605,21340,"El Paso, TX Metro Area",Rail,2009,0,0,0,0,
1606,21340,"El Paso, TX Metro Area",Rail,2010,0,0,0,0,
1607,21340,"El Paso, TX Metro Area",Rail,2011,0,0,0,0,
1608,21340,"El Paso, TX Metro Area",Rail,2012,0,0,0,0,
1609,21340,"El Paso, TX Metro Area",Rail,2013,0,0,0,0,
1610,21340,"El Paso, TX Metro Area",Rail,2014,0,0,0,0,
1611,21340,"El Paso, TX Metro Area",Rail,2015,0,0,0,0,
1612,21340,"El Paso, TX Metro Area",Rail,2016,0,0,0,0,
1613,21340,"El Paso, TX Metro Area",Rail,2017,0,0,0,0,
1614,21340,"El Paso, TX Metro Area",Rail,2018,0,0,0,0,
1649,21500,"Erie, PA Metro Area",Bus,2002,185,101,286,0,
1650,21500,"Erie, PA Metro Area",Bus,2003,99,152,251,0,
1651,21500,"Erie, PA Metro Area",Bus,2004,18,22,40,1,Inconsistent
1652,21500,"Erie, PA Metro Area",Bus,2005,56,296,352,0,
1653,21500,"Erie, PA Metro Area",Bus,2006,70,272,342,0,
1654,21500,"Erie, PA Metro Area",Bus,2007,167,285,452,0,
1655,21500,"Erie, PA Metro Area",Bus,2008,176,263,439,0,
1656,21500,"Erie, PA Metro Area",Bus,2009,168,252,420,0,
1657,21500,"Erie, PA Metro Area",Bus,2010,209,148,357,0,
1658,21500,"Erie, PA Metro Area",Bus,2011,222,167,389,0,
1659,21500,"Erie, PA Metro Area",Bus,2012,111,268,379,0,
1660,21500,"Erie, PA Metro Area",Bus,2013,125,326,451,0,
1661,21500,"Erie, PA Metro Area",Bus,2014,257,222,479,0,
1662,21500,"Erie, PA Metro Area",Bus,2015,248,321,569,0,
1663,21500,"Erie, PA Metro Area",Bus,2016,270,263,533,0,
1664,21500,"Erie, PA Metro Area",Bus,2017,383,108,491,0,
1665,21500,"Erie, PA Metro Area",Bus,2018,321,111,432,0,
1666,21660,"Eugene-Springfield, OR Metro Area",Bus,2002,585,648,1233,0,
1667,21660,"Eugene-Springfield, OR Metro Area",Bus,2003,617,485,1102,0,
1668,21660,"Eugene-Springfield, OR Metro Area",Bus,2004,612,505,1117,0,
1669,21660,"Eugene-Springfield, OR Metro Area",Bus,2005,605,461,1066,0,
1670,21660,"Eugene-Springfield, OR Metro Area",Bus,2006,781,490,1271,0,
1671,21660,"Eugene-Springfield, OR Metro Area",Bus,2007,660,309,969,0,
1672,21660,"Eugene-Springfield, OR Metro Area",Bus,2008,677,282,959,0,
1673,21660,"Eugene-Springfield, OR Metro Area",Bus,2009,866,351,1217,0,
1674,21660,"Eugene-Springfield, OR Metro Area",Bus,2010,770,454,1224,0,
1675,21660,"Eugene-Springfield, OR Metro Area",Bus,2011,703,439,1142,0,
1676,21660,"Eugene-Springfield, OR Metro Area",Bus,2012,585,442,1027,0,
1677,21660,"Eugene-Springfield, OR Metro Area",Bus,2013,462,206,668,0,
1678,21660,"Eugene-Springfield, OR Metro Area",Bus,2014,601,240,841,0,
1679,21660,"Eugene-Springfield, OR Metro Area",Bus,2015,621,249,870,0,
1680,21660,"Eugene-Springfield, OR Metro Area",Bus,2016,602,277,879,0,
1681,21660,"Eugene-Springfield, OR Metro Area",Bus,2017,524,281,805,0,
1682,21660,"Eugene-Springfield, OR Metro Area",Bus,2018,561,325,886,0,
1683,21780,"Evansville, IN-KY Metro Area",Bus,2002,352,486,838,0,
1684,21780,"Evansville, IN-KY Metro Area",Bus,2003,384,520,904,0,
1685,21780,"Evansville, IN-KY Metro Area",Bus,2004,530,479,1009,0,
1686,21780,"Evansville, IN-KY Metro Area",Bus,2005,551,498,1049,0,
1687,21780,"Evansville, IN-KY Metro Area",Bus,2006,557,512,1069,0,
1688,21780,"Evansville, IN-KY Metro Area",Bus,2007,563,572,1135,0,
1689,21780,"Evansville, IN-KY Metro Area",Bus,2008,567,600,1167,0,
1690,21780,"Evansville, IN-KY Metro Area",Bus,2009,144,240,384,0,
1691,21780,"Evansville, IN-KY Metro Area",Bus,2010,71,62,133,0,
1692,21780,"Evansville, IN-KY Metro Area",Bus,2011,96,136,232,0,
1693,21780,"Evansville, IN-KY Metro Area",Bus,2012,203,120,323,0,
1694,21780,"Evansville, IN-KY Metro Area",Bus,2013,38,24,62,0,
1695,21780,"Evansville, IN-KY Metro Area",Bus,2014,34,19,53,0,
1696,21780,"Evansville, IN-KY Metro Area",Bus,2015,23,183,206,0,
1697,21780,"Evansville, IN-KY Metro Area",Bus,2016,25,17,42,0,
1698,21780,"Evansville, IN-KY Metro Area",Bus,2017,20,46,66,0,
1699,21780,"Evansville, IN-KY Metro Area",Bus,2018,19,32,51,0,
1717,22020,"Fargo, ND-MN Metro Area",Bus,2002,0,0,0,1,Not reported
1718,22020,"Fargo, ND-MN Metro Area",Bus,2003,0,0,0,1,Not reported
1719,22020,"Fargo, ND-MN Metro Area",Bus,2004,0,0,0,1,Not reported
1720,22020,"Fargo, ND-MN Metro Area",Bus,2005,0,0,0,1,Not reported
1721,22020,"Fargo, ND-MN Metro Area",Bus,2006,0,0,0,1,Not reported
1722,22020,"Fargo, ND-MN Metro Area",Bus,2007,0,0,0,1,Not reported
1723,22020,"Fargo, ND-MN Metro Area",Bus,2008,0,0,0,1,Not reported
1724,22020,"Fargo, ND-MN Metro Area",Bus,2009,36,9,45,1,Not reported
1725,22020,"Fargo, ND-MN Metro Area",Bus,2010,50,88,138,0,
1726,22020,"Fargo, ND-MN Metro Area",Bus,2011,57,86,143,0,
1727,22020,"Fargo, ND-MN Metro Area",Bus,2012,58,46,104,0,
1728,22020,"Fargo, ND-MN Metro Area",Bus,2013,76,40,116,0,
1729,22020,"Fargo, ND-MN Metro Area",Bus,2014,90,37,127,0,
1730,22020,"Fargo, ND-MN Metro Area",Bus,2015,58,47,105,0,
1731,22020,"Fargo, ND-MN Metro Area",Bus,2016,60,77,137,0,
1732,22020,"Fargo, ND-MN Metro Area",Bus,2017,38,40,78,0,
1733,22020,"Fargo, ND-MN Metro Area",Bus,2018,36,106,142,0,
1734,22180,"Fayetteville, NC Metro Area",Bus,2002,95,0,95,0,
1735,22180,"Fayetteville, NC Metro Area",Bus,2003,15,0,15,0,
1736,22180,"Fayetteville, NC Metro Area",Bus,2004,33,22,55,0,
1737,22180,"Fayetteville, NC Metro Area",Bus,2005,45,13,58,0,
1738,22180,"Fayetteville, NC Metro Area",Bus,2006,63,7,70,0,
1739,22180,"Fayetteville, NC Metro Area",Bus,2007,75,45,120,0,
1740,22180,"Fayetteville, NC Metro Area",Bus,2008,66,28,94,0,
1741,22180,"Fayetteville, NC Metro Area",Bus,2009,37,0,37,0,
1742,22180,"Fayetteville, NC Metro Area",Bus,2010,41,7,48,0,
1743,22180,"Fayetteville, NC Metro Area",Bus,2011,50,18,68,0,
1744,22180,"Fayetteville, NC Metro Area",Bus,2012,35,13,48,0,
1745,22180,"Fayetteville, NC Metro Area",Bus,2013,42,29,71,0,
1746,22180,"Fayetteville, NC Metro Area",Bus,2014,41,20,61,0,
1747,22180,"Fayetteville, NC Metro Area",Bus,2015,47,23,70,0,
1748,22180,"Fayetteville, NC Metro Area",Bus,2016,75,26,101,0,
1749,22180,"Fayetteville, NC Metro Area",Bus,2017,67,15,82,0,
1750,22180,"Fayetteville, NC Metro Area",Bus,2018,73,25,98,0,
1751,22380,"Flagstaff, AZ Metro Area",Bus,2002,67,527,594,0,
1752,22380,"Flagstaff, AZ Metro Area",Bus,2003,0,0,0,1,Not reported
1753,22380,"Flagstaff, AZ Metro Area",Bus,2004,55,79,134,0,
1754,22380,"Flagstaff, AZ Metro Area",Bus,2005,67,93,160,0,
1755,22380,"Flagstaff, AZ Metro Area",Bus,2006,51,125,176,0,
1756,22380,"Flagstaff, AZ Metro Area",Bus,2007,64,141,205,0,
1757,22380,"Flagstaff, AZ Metro Area",Bus,2008,164,0,164,0,
1758,22380,"Flagstaff, AZ Metro Area",Bus,2009,156,0,156,0,
1759,22380,"Flagstaff, AZ Metro Area",Bus,2010,137,0,137,0,
1760,22380,"Flagstaff, AZ Metro Area",Bus,2011,18,145,163,0,
1761,22380,"Flagstaff, AZ Metro Area",Bus,2012,57,89,146,0,
1762,22380,"Flagstaff, AZ Metro Area",Bus,2013,114,48,162,0,
1763,22380,"Flagstaff, AZ Metro Area",Bus,2014,125,95,220,0,
1764,22380,"Flagstaff, AZ Metro Area",Bus,2015,135,69,204,0,
1765,22380,"Flagstaff, AZ Metro Area",Bus,2016,95,51,146,0,
1766,22380,"Flagstaff, AZ Metro Area",Bus,2017,97,68,165,0,
1767,22380,"Flagstaff, AZ Metro Area",Bus,2018,89,93,182,0,
1768,22420,"Flint, MI Metro Area",Bus,2002,281,942,1223,0,
1769,22420,"Flint, MI Metro Area",Bus,2003,428,124,552,0,
1770,22420,"Flint, MI Metro Area",Bus,2004,628,267,895,0,
1771,22420,"Flint, MI Metro Area",Bus,2005,772,290,1062,0,
1772,22420,"Flint, MI Metro Area",Bus,2006,759,225,984,0,
1773,22420,"Flint, MI Metro Area",Bus,2007,650,268,918,0,
1774,22420,"Flint, MI Metro Area",Bus,2008,413,296,709,0,
1775,22420,"Flint, MI Metro Area",Bus,2009,559,128,687,0,
1776,22420,"Flint, MI Metro Area",Bus,2010,628,63,691,0,
1777,22420,"Flint, MI Metro Area",Bus,2011,649,164,813,0,
1778,22420,"Flint, MI Metro Area",Bus,2012,576,75,651,0,
1779,22420,"Flint, MI Metro Area",Bus,2013,642,76,718,0,
1780,22420,"Flint, MI Metro Area",Bus,2014,653,99,752,0,
1781,22420,"Flint, MI Metro Area",Bus,2015,597,80,677,0,
1782,22420,"Flint, MI Metro Area",Bus,2016,474,88,562,0,
1783,22420,"Flint, MI Metro Area",Bus,2017,419,93,512,0,
1784,22420,"Flint, MI Metro Area",Bus,2018,512,408,920,0,
1785,22660,"Fort Collins-Loveland, CO Metro Area",Bus,2002,31,37,68,1,Inconsistent
1786,22660,"Fort Collins-Loveland, CO Metro Area",Bus,2003,34,27,61,1,Inconsistent
1787,22660,"Fort Collins-Loveland, CO Metro Area",Bus,2004,32,34,66,1,Inconsistent
1788,22660,"Fort Collins-Loveland, CO Metro Area",Bus,2005,30,68,98,1,Inconsistent
1789,22660,"Fort Collins-Loveland, CO Metro Area",Bus,2006,27,36,63,1,Inconsistent
1790,22660,"Fort Collins-Loveland, CO Metro Area",Bus,2007,34,32,66,1,Inconsistent
1791,22660,"Fort Collins-Loveland, CO Metro Area",Bus,2008,61,150,211,0,
1792,22660,"Fort Collins-Loveland, CO Metro Area",Bus,2009,61,123,184,0,
1793,22660,"Fort Collins-Loveland, CO Metro Area",Bus,2010,55,101,156,0,
1794,22660,"Fort Collins-Loveland, CO Metro Area",Bus,2011,152,58,210,0,
1795,22660,"Fort Collins-Loveland, CO Metro Area",Bus,2012,158,48,206,0,
1796,22660,"Fort Collins-Loveland, CO Metro Area",Bus,2013,57,134,191,0,
1797,22660,"Fort Collins-Loveland, CO Metro Area",Bus,2014,57,193,250,0,
1798,22660,"Fort Collins-Loveland, CO Metro Area",Bus,2015,127,417,544,0,
1799,22660,"Fort Collins-Loveland, CO Metro Area",Bus,2016,109,163,272,0,
1800,22660,"Fort Collins-Loveland, CO Metro Area",Bus,2017,183,111,294,0,
1801,22660,"Fort Collins-Loveland, CO Metro Area",Bus,2018,182,115,297,0,
1836,23060,"Fort Wayne, IN Metro Area",Bus,2002,37,100,137,0,
1837,23060,"Fort Wayne, IN Metro Area",Bus,2003,57,110,167,0,
1838,23060,"Fort Wayne, IN Metro Area",Bus,2004,0,178,178,0,
1839,23060,"Fort Wayne, IN Metro Area",Bus,2005,125,26,151,0,
1840,23060,"Fort Wayne, IN Metro Area",Bus,2006,98,40,138,0,
1841,23060,"Fort Wayne, IN Metro Area",Bus,2007,87,73,160,0,
1842,23060,"Fort Wayne, IN Metro Area",Bus,2008,58,51,109,0,
1843,23060,"Fort Wayne, IN Metro Area",Bus,2009,61,33,94,0,
1844,23060,"Fort Wayne, IN Metro Area",Bus,2010,61,19,80,0,
1845,23060,"Fort Wayne, IN Metro Area",Bus,2011,50,20,70,0,
1846,23060,"Fort Wayne, IN Metro Area",Bus,2012,54,84,138,0,
1847,23060,"Fort Wayne, IN Metro Area",Bus,2013,54,84,138,0,
1848,23060,"Fort Wayne, IN Metro Area",Bus,2014,38,37,75,0,
1849,23060,"Fort Wayne, IN Metro Area",Bus,2015,42,139,181,0,
1850,23060,"Fort Wayne, IN Metro Area",Bus,2016,18,363,381,0,
1851,23060,"Fort Wayne, IN Metro Area",Bus,2017,19,258,277,0,
1852,23060,"Fort Wayne, IN Metro Area",Bus,2018,22,309,331,0,
1870,23420,"Fresno, CA Metro Area",Bus,2002,809,426,1235,0,
1871,23420,"Fresno, CA Metro Area",Bus,2003,789,347,1136,0,
1872,23420,"Fresno, CA Metro Area",Bus,2004,870,308,1178,0,
1873,23420,"Fresno, CA Metro Area",Bus,2005,812,278,1090,0,
1874,23420,"Fresno, CA Metro Area",Bus,2006,903,290,1193,0,
1875,23420,"Fresno, CA Metro Area",Bus,2007,740,251,991,0,
1876,23420,"Fresno, CA Metro Area",Bus,2008,752,199,951,0,
1877,23420,"Fresno, CA Metro Area",Bus,2009,859,240,1099,0,
1878,23420,"Fresno, CA Metro Area",Bus,2010,833,281,1114,0,
1879,23420,"Fresno, CA Metro Area",Bus,2011,518,121,639,0,
1880,23420,"Fresno, CA Metro Area",Bus,2012,509,103,612,0,
1881,23420,"Fresno, CA Metro Area",Bus,2013,409,113,522,0,
1882,23420,"Fresno, CA Metro Area",Bus,2014,468,178,646,0,
1883,23420,"Fresno, CA Metro Area",Bus,2015,506,156,662,0,
1884,23420,"Fresno, CA Metro Area",Bus,2016,642,179,821,0,
1885,23420,"Fresno, CA Metro Area",Bus,2017,372,89,461,0,
1886,23420,"Fresno, CA Metro Area",Bus,2018,226,154,380,0,
1887,23540,"Gainesville, FL Metro Area",Bus,2002,313,213,526,0,
1888,23540,"Gainesville, FL Metro Area",Bus,2003,530,266,796,0,
1889,23540,"Gainesville, FL Metro Area",Bus,2004,543,247,790,0,
1890,23540,"Gainesville, FL Metro Area",Bus,2005,421,214,635,0,
1891,23540,"Gainesville, FL Metro Area",Bus,2006,503,301,804,0,
1892,23540,"Gainesville, FL Metro Area",Bus,2007,363,442,805,0,
1893,23540,"Gainesville, FL Metro Area",Bus,2008,352,347,699,0,
1894,23540,"Gainesville, FL Metro Area",Bus,2009,418,257,675,0,
1895,23540,"Gainesville, FL Metro Area",Bus,2010,258,255,513,0,
1896,23540,"Gainesville, FL Metro Area",Bus,2011,161,333,494,0,
1897,23540,"Gainesville, FL Metro Area",Bus,2012,130,323,453,0,
1898,23540,"Gainesville, FL Metro Area",Bus,2013,115,276,391,0,
1899,23540,"Gainesville, FL Metro Area",Bus,2014,122,267,389,0,
1900,23540,"Gainesville, FL Metro Area",Bus,2015,118,253,371,0,
1901,23540,"Gainesville, FL Metro Area",Bus,2016,102,257,359,0,
1902,23540,"Gainesville, FL Metro Area",Bus,2017,192,261,453,0,
1903,23540,"Gainesville, FL Metro Area",Bus,2018,264,620,884,0,
1904,24220,"Grand Forks, ND-MN Metro Area",Bus,2002,22,1,23,1,Inconsistent
1905,24220,"Grand Forks, ND-MN Metro Area",Bus,2003,13,3,16,1,Inconsistent
1906,24220,"Grand Forks, ND-MN Metro Area",Bus,2004,4,0,4,1,Inconsistent
1907,24220,"Grand Forks, ND-MN Metro Area",Bus,2005,2,0,2,1,Inconsistent
1908,24220,"Grand Forks, ND-MN Metro Area",Bus,2006,2,1,3,1,Inconsistent
1909,24220,"Grand Forks, ND-MN Metro Area",Bus,2007,52,102,154,0,
1910,24220,"Grand Forks, ND-MN Metro Area",Bus,2008,83,155,238,0,
1911,24220,"Grand Forks, ND-MN Metro Area",Bus,2009,70,153,223,0,
1912,24220,"Grand Forks, ND-MN Metro Area",Bus,2010,54,95,149,0,
1913,24220,"Grand Forks, ND-MN Metro Area",Bus,2011,31,51,82,0,
1914,24220,"Grand Forks, ND-MN Metro Area",Bus,2012,6,71,77,0,
1915,24220,"Grand Forks, ND-MN Metro Area",Bus,2013,10,83,93,0,
1916,24220,"Grand Forks, ND-MN Metro Area",Bus,2014,8,111,119,0,
1917,24220,"Grand Forks, ND-MN Metro Area",Bus,2015,4,143,147,0,
1918,24220,"Grand Forks, ND-MN Metro Area",Bus,2016,2,115,117,0,
1919,24220,"Grand Forks, ND-MN Metro Area",Bus,2017,5,78,83,0,
1920,24220,"Grand Forks, ND-MN Metro Area",Bus,2018,4,98,102,0,
1921,24340,"Grand Rapids-Wyoming, MI Metro Area",Bus,2002,400,351,751,0,
1923,24340,"Grand Rapids-Wyoming, MI Metro Area",Bus,2003,260,150,410,0,
1925,24340,"Grand Rapids-Wyoming, MI Metro Area",Bus,2004,639,377,1016,0,
1927,24340,"Grand Rapids-Wyoming, MI Metro Area",Bus,2005,1088,336,1424,0,
1929,24340,"Grand Rapids-Wyoming, MI Metro Area",Bus,2006,1205,376,1581,0,
1931,24340,"Grand Rapids-Wyoming, MI Metro Area",Bus,2007,364,961,1325,0,
1933,24340,"Grand Rapids-Wyoming, MI Metro Area",Bus,2008,126,865,991,0,
1935,24340,"Grand Rapids-Wyoming, MI Metro Area",Bus,2009,109,1003,1112,0,
1937,24340,"Grand Rapids-Wyoming, MI Metro Area",Bus,2010,144,691,835,0,
1939,24340,"Grand Rapids-Wyoming, MI Metro Area",Bus,2011,151,897,1048,0,
1941,24340,"Grand Rapids-Wyoming, MI Metro Area",Bus,2012,115,1051,1166,0,
1943,24340,"Grand Rapids-Wyoming, MI Metro Area",Bus,2013,390,1448,1838,0,
1945,24340,"Grand Rapids-Wyoming, MI Metro Area",Bus,2014,682,1295,1977,0,
1947,24340,"Grand Rapids-Wyoming, MI Metro Area",Bus,2015,197,1900,2097,0,
1949,24340,"Grand Rapids-Wyoming, MI Metro Area",Bus,2016,270,669,939,0,
1951,24340,"Grand Rapids-Wyoming, MI Metro Area",Bus,2017,95,523,618,0,
1953,24340,"Grand Rapids-Wyoming, MI Metro Area",Bus,2018,262,313,575,0,
1955,24500,"Great Falls, MT Metro Area",Bus,2002,110,54,164,0,
1956,24500,"Great Falls, MT Metro Area",Bus,2003,132,15,147,0,
1957,24500,"Great Falls, MT Metro Area",Bus,2004,0,0,0,1,Inconsistent
1958,24500,"Great Falls, MT Metro Area",Bus,2005,0,0,0,1,Inconsistent
1959,24500,"Great Falls, MT Metro Area",Bus,2006,3,0,3,1,Inconsistent
1960,24500,"Great Falls, MT Metro Area",Bus,2007,0,74,74,0,
1961,24500,"Great Falls, MT Metro Area",Bus,2008,42,113,155,0,
1962,24500,"Great Falls, MT Metro Area",Bus,2009,145,13,158,0,
1963,24500,"Great Falls, MT Metro Area",Bus,2010,161,14,175,0,
1964,24500,"Great Falls, MT Metro Area",Bus,2011,131,18,149,0,
1965,24500,"Great Falls, MT Metro Area",Bus,2012,61,8,69,1,Inconsistent
1966,24500,"Great Falls, MT Metro Area",Bus,2013,54,11,65,1,Inconsistent
1967,24500,"Great Falls, MT Metro Area",Bus,2014,54,2,56,1,Inconsistent
1968,24500,"Great Falls, MT Metro Area",Bus,2015,47,1,48,1,Inconsistent
1969,24500,"Great Falls, MT Metro Area",Bus,2016,103,13,116,0,
1970,24500,"Great Falls, MT Metro Area",Bus,2017,120,5,125,0,
1971,24500,"Great Falls, MT Metro Area",Bus,2018,133,9,142,0,
1972,24580,"Green Bay, WI Metro Area",Bus,2002,122,181,303,0,
1973,24580,"Green Bay, WI Metro Area",Bus,2003,118,204,322,0,
1974,24580,"Green Bay, WI Metro Area",Bus,2004,86,176,262,0,
1975,24580,"Green Bay, WI Metro Area",Bus,2005,74,162,236,0,
1976,24580,"Green Bay, WI Metro Area",Bus,2006,79,183,262,0,
1977,24580,"Green Bay, WI Metro Area",Bus,2007,85,95,180,0,
1978,24580,"Green Bay, WI Metro Area",Bus,2008,103,177,280,0,
1979,24580,"Green Bay, WI Metro Area",Bus,2009,84,160,244,0,
1980,24580,"Green Bay, WI Metro Area",Bus,2010,34,89,123,0,
1981,24580,"Green Bay, WI Metro Area",Bus,2011,41,103,144,0,
1982,24580,"Green Bay, WI Metro Area",Bus,2012,37,74,111,0,
1983,24580,"Green Bay, WI Metro Area",Bus,2013,40,202,242,0,
1984,24580,"Green Bay, WI Metro Area",Bus,2014,109,199,308,0,
1985,24580,"Green Bay, WI Metro Area",Bus,2015,179,146,325,0,
1986,24580,"Green Bay, WI Metro Area",Bus,2016,64,191,255,0,
1987,24580,"Green Bay, WI Metro Area",Bus,2017,53,200,253,0,
1988,24580,"Green Bay, WI Metro Area",Bus,2018,35,119,154,0,
1989,24660,"Greensboro-High Point, NC Metro Area",Bus,2002,0,0,0,1,Not consistent
1990,24660,"Greensboro-High Point, NC Metro Area",Bus,2003,0,0,0,1,Not consistent
1991,24660,"Greensboro-High Point, NC Metro Area",Bus,2004,0,0,0,1,Not consistent
1992,24660,"Greensboro-High Point, NC Metro Area",Bus,2005,0,0,0,1,Not consistent
1993,24660,"Greensboro-High Point, NC Metro Area",Bus,2006,0,0,0,1,Not consistent
1994,24660,"Greensboro-High Point, NC Metro Area",Bus,2007,0,0,0,1,Not consistent
1995,24660,"Greensboro-High Point, NC Metro Area",Bus,2008,0,0,0,1,Not consistent
1996,24660,"Greensboro-High Point, NC Metro Area",Bus,2009,171,159,330,0,
1997,24660,"Greensboro-High Point, NC Metro Area",Bus,2010,298,349,647,0,
1998,24660,"Greensboro-High Point, NC Metro Area",Bus,2011,239,327,566,0,
1999,24660,"Greensboro-High Point, NC Metro Area",Bus,2012,231,183,414,0,
2000,24660,"Greensboro-High Point, NC Metro Area",Bus,2013,238,196,434,0,
2001,24660,"Greensboro-High Point, NC Metro Area",Bus,2014,59,206,265,0,
2002,24660,"Greensboro-High Point, NC Metro Area",Bus,2015,63,221,284,0,
2003,24660,"Greensboro-High Point, NC Metro Area",Bus,2016,86,116,202,0,
2004,24660,"Greensboro-High Point, NC Metro Area",Bus,2017,94,138,232,0,
2005,24660,"Greensboro-High Point, NC Metro Area",Bus,2018,101,153,254,0,
2006,25060,"Gulfport-Biloxi, MS Metro Area",Bus,2002,101,80,181,0,
2008,25060,"Gulfport-Biloxi, MS Metro Area",Bus,2003,156,191,347,0,
2010,25060,"Gulfport-Biloxi, MS Metro Area",Bus,2004,128,145,273,0,
2012,25060,"Gulfport-Biloxi, MS Metro Area",Bus,2005,120,199,319,0,
2014,25060,"Gulfport-Biloxi, MS Metro Area",Bus,2006,104,77,181,0,
2016,25060,"Gulfport-Biloxi, MS Metro Area",Bus,2007,96,84,180,0,
2018,25060,"Gulfport-Biloxi, MS Metro Area",Bus,2008,69,109,178,0,
2020,25060,"Gulfport-Biloxi, MS Metro Area",Bus,2009,107,154,261,0,
2022,25060,"Gulfport-Biloxi, MS Metro Area",Bus,2010,119,310,429,0,
2024,25060,"Gulfport-Biloxi, MS Metro Area",Bus,2011,122,313,435,0,
2026,25060,"Gulfport-Biloxi, MS Metro Area",Bus,2012,142,398,540,0,
2028,25060,"Gulfport-Biloxi, MS Metro Area",Bus,2013,230,458,688,0,
2030,25060,"Gulfport-Biloxi, MS Metro Area",Bus,2014,241,374,615,0,
2032,25060,"Gulfport-Biloxi, MS Metro Area",Bus,2015,225,356,581,0,
2034,25060,"Gulfport-Biloxi, MS Metro Area",Bus,2016,211,137,348,0,
2036,25060,"Gulfport-Biloxi, MS Metro Area",Bus,2017,151,210,361,0,
2038,25060,"Gulfport-Biloxi, MS Metro Area",Bus,2018,128,242,370,0,
2040,25260,"Hanford-Corcoran, CA Metro Area",Bus,2002,0,0,0,1,Not reported
2041,25260,"Hanford-Corcoran, CA Metro Area",Bus,2003,0,0,0,1,Not reported
2042,25260,"Hanford-Corcoran, CA Metro Area",Bus,2004,0,0,0,1,Not reported
2043,25260,"Hanford-Corcoran, CA Metro Area",Bus,2005,0,0,0,1,Not reported
2044,25260,"Hanford-Corcoran, CA Metro Area",Bus,2006,0,0,0,1,Not reported
2045,25260,"Hanford-Corcoran, CA Metro Area",Bus,2007,0,0,0,1,Not reported
2046,25260,"Hanford-Corcoran, CA Metro Area",Bus,2008,0,3,3,1,Not reported
2047,25260,"Hanford-Corcoran, CA Metro Area",Bus,2009,4,7,11,0,
2048,25260,"Hanford-Corcoran, CA Metro Area",Bus,2010,7,10,17,0,
2049,25260,"Hanford-Corcoran, CA Metro Area",Bus,2011,13,23,36,0,
2050,25260,"Hanford-Corcoran, CA Metro Area",Bus,2012,9,15,24,0,
2051,25260,"Hanford-Corcoran, CA Metro Area",Bus,2013,17,17,34,0,
2052,25260,"Hanford-Corcoran, CA Metro Area",Bus,2014,24,6,30,0,
2053,25260,"Hanford-Corcoran, CA Metro Area",Bus,2015,24,12,36,0,
2054,25260,"Hanford-Corcoran, CA Metro Area",Bus,2016,43,9,52,0,
2055,25260,"Hanford-Corcoran, CA Metro Area",Bus,2017,19,15,34,0,
2056,25260,"Hanford-Corcoran, CA Metro Area",Bus,2018,77,21,98,0,
2057,25420,"Harrisburg-Carlisle, PA Metro Area",Bus,2002,137,342,479,0,
2058,25420,"Harrisburg-Carlisle, PA Metro Area",Bus,2003,258,271,529,0,
2059,25420,"Harrisburg-Carlisle, PA Metro Area",Bus,2004,240,215,455,0,
2060,25420,"Harrisburg-Carlisle, PA Metro Area",Bus,2005,290,224,514,0,
2061,25420,"Harrisburg-Carlisle, PA Metro Area",Bus,2006,280,275,555,0,
2062,25420,"Harrisburg-Carlisle, PA Metro Area",Bus,2007,286,242,528,0,
2063,25420,"Harrisburg-Carlisle, PA Metro Area",Bus,2008,344,231,575,0,
2064,25420,"Harrisburg-Carlisle, PA Metro Area",Bus,2009,354,261,615,0,
2065,25420,"Harrisburg-Carlisle, PA Metro Area",Bus,2010,389,264,653,0,
2066,25420,"Harrisburg-Carlisle, PA Metro Area",Bus,2011,459,248,707,0,
2067,25420,"Harrisburg-Carlisle, PA Metro Area",Bus,2012,457,187,644,0,
2068,25420,"Harrisburg-Carlisle, PA Metro Area",Bus,2013,244,143,387,0,
2069,25420,"Harrisburg-Carlisle, PA Metro Area",Bus,2014,159,238,397,0,
2070,25420,"Harrisburg-Carlisle, PA Metro Area",Bus,2015,120,343,463,0,
2071,25420,"Harrisburg-Carlisle, PA Metro Area",Bus,2016,242,148,390,0,
2072,25420,"Harrisburg-Carlisle, PA Metro Area",Bus,2017,236,145,381,0,
2073,25420,"Harrisburg-Carlisle, PA Metro Area",Bus,2018,314,135,449,0,
2074,25500,"Harrisonburg, VA Metro Area",Bus,2002,0,0,0,1,Not reported
2075,25500,"Harrisonburg, VA Metro Area",Bus,2003,0,0,0,1,Not reported
2076,25500,"Harrisonburg, VA Metro Area",Bus,2004,0,0,0,1,Not reported
2077,25500,"Harrisonburg, VA Metro Area",Bus,2005,36,0,36,0,
2078,25500,"Harrisonburg, VA Metro Area",Bus,2006,6,53,59,0,
2079,25500,"Harrisonburg, VA Metro Area",Bus,2007,32,71,103,0,
2080,25500,"Harrisonburg, VA Metro Area",Bus,2008,46,88,134,0,
2081,25500,"Harrisonburg, VA Metro Area",Bus,2009,96,114,210,0,
2082,25500,"Harrisonburg, VA Metro Area",Bus,2010,69,84,153,0,
2083,25500,"Harrisonburg, VA Metro Area",Bus,2011,37,55,92,0,
2084,25500,"Harrisonburg, VA Metro Area",Bus,2012,16,61,77,0,
2085,25500,"Harrisonburg, VA Metro Area",Bus,2013,17,48,65,0,
2086,25500,"Harrisonburg, VA Metro Area",Bus,2014,6,46,52,0,
2087,25500,"Harrisonburg, VA Metro Area",Bus,2015,54,29,83,0,
2088,25500,"Harrisonburg, VA Metro Area",Bus,2016,75,19,94,0,
2089,25500,"Harrisonburg, VA Metro Area",Bus,2017,75,18,93,0,
2090,25500,"Harrisonburg, VA Metro Area",Bus,2018,84,37,121,0,
2091,25540,"Hartford-West Hartford-East Hartford, CT Metro Area",Bus,2002,1900,1018,2918,0,
4811,25540,"Hartford-West Hartford-East Hartford, CT Metro Area",Bus,2002,0,0,0,1,Not reported
2092,25540,"Hartford-West Hartford-East Hartford, CT Metro Area",Bus,2003,1764,1079,2843,0,
4813,25540,"Hartford-West Hartford-East Hartford, CT Metro Area",Bus,2003,0,0,0,1,Not reported
2093,25540,"Hartford-West Hartford-East Hartford, CT Metro Area",Bus,2004,1911,1270,3181,0,
4815,25540,"Hartford-West Hartford-East Hartford, CT Metro Area",Bus,2004,0,0,0,1,Not reported
2094,25540,"Hartford-West Hartford-East Hartford, CT Metro Area",Bus,2005,2021,2142,4163,0,
4817,25540,"Hartford-West Hartford-East Hartford, CT Metro Area",Bus,2005,0,0,0,1,Not reported
2095,25540,"Hartford-West Hartford-East Hartford, CT Metro Area",Bus,2006,1876,3020,4896,0,
4819,25540,"Hartford-West Hartford-East Hartford, CT Metro Area",Bus,2006,0,0,0,1,Not reported
2096,25540,"Hartford-West Hartford-East Hartford, CT Metro Area",Bus,2007,1650,2764,4414,0,
4821,25540,"Hartford-West Hartford-East Hartford, CT Metro Area",Bus,2007,0,0,0,1,Not reported
2097,25540,"Hartford-West Hartford-East Hartford, CT Metro Area",Bus,2008,1415,2147,3562,0,
4823,25540,"Hartford-West Hartford-East Hartford, CT Metro Area",Bus,2008,0,0,0,1,Not reported
2098,25540,"Hartford-West Hartford-East Hartford, CT Metro Area",Bus,2009,1287,2188,3475,0,
4825,25540,"Hartford-West Hartford-East Hartford, CT Metro Area",Bus,2009,257,2717,2974,0,
2099,25540,"Hartford-West Hartford-East Hartford, CT Metro Area",Bus,2010,1240,2144,3384,0,
4827,25540,"Hartford-West Hartford-East Hartford, CT Metro Area",Bus,2010,415,1560,1975,0,
2100,25540,"Hartford-West Hartford-East Hartford, CT Metro Area",Bus,2011,1284,2475,3759,0,
4829,25540,"Hartford-West Hartford-East Hartford, CT Metro Area",Bus,2011,434,1733,2167,0,
2101,25540,"Hartford-West Hartford-East Hartford, CT Metro Area",Bus,2012,1557,2476,4033,0,
4831,25540,"Hartford-West Hartford-East Hartford, CT Metro Area",Bus,2012,361,2196,2557,0,
2102,25540,"Hartford-West Hartford-East Hartford, CT Metro Area",Bus,2013,942,2731,3673,0,
4833,25540,"Hartford-West Hartford-East Hartford, CT Metro Area",Bus,2013,611,1834,2445,0,
2103,25540,"Hartford-West Hartford-East Hartford, CT Metro Area",Bus,2014,490,4472,4962,0,
4835,25540,"Hartford-West Hartford-East Hartford, CT Metro Area",Bus,2014,749,2275,3024,0,
2104,25540,"Hartford-West Hartford-East Hartford, CT Metro Area",Bus,2015,528,4923,5451,0,
4837,25540,"Hartford-West Hartford-East Hartford, CT Metro Area",Bus,2015,1027,2672,3699,0,
2105,25540,"Hartford-West Hartford-East Hartford, CT Metro Area",Bus,2016,467,5648,6115,0,
4839,25540,"Hartford-West Hartford-East Hartford, CT Metro Area",Bus,2016,900,2517,3417,0,
2106,25540,"Hartford-West Hartford-East Hartford, CT Metro Area",Bus,2017,492,4396,4888,0,
4841,25540,"Hartford-West Hartford-East Hartford, CT Metro Area",Bus,2017,873,2501,3374,0,
2107,25540,"Hartford-West Hartford-East Hartford, CT Metro Area",Bus,2018,460,3527,3987,0,
4843,25540,"Hartford-West Hartford-East Hartford, CT Metro Area",Bus,2018,1073,2899,3972,0,
2108,25540,"Hartford-West Hartford-East Hartford, CT Metro Area",Rail,2002,0,0,0,1,Not reported
2109,25540,"Hartford-West Hartford-East Hartford, CT Metro Area",Rail,2003,0,0,0,1,Not reported
2110,25540,"Hartford-West Hartford-East Hartford, CT Metro Area",Rail,2004,0,0,0,1,Not reported
2111,25540,"Hartford-West Hartford-East Hartford, CT Metro Area",Rail,2005,0,0,0,1,Not reported
2112,25540,"Hartford-West Hartford-East Hartford, CT Metro Area",Rail,2006,0,0,0,1,Not reported
2113,25540,"Hartford-West Hartford-East Hartford, CT Metro Area",Rail,2007,0,0,0,1,Not reported
2114,25540,"Hartford-West Hartford-East Hartford, CT Metro Area",Rail,2008,0,0,0,1,Not reported
2115,25540,"Hartford-West Hartford-East Hartford, CT Metro Area",Rail,2009,16,80,96,0,
2116,25540,"Hartford-West Hartford-East Hartford, CT Metro Area",Rail,2010,7,98,105,0,
2117,25540,"Hartford-West Hartford-East Hartford, CT Metro Area",Rail,2011,23,111,134,0,
2118,25540,"Hartford-West Hartford-East Hartford, CT Metro Area",Rail,2012,46,74,120,0,
2119,25540,"Hartford-West Hartford-East Hartford, CT Metro Area",Rail,2013,35,40,75,0,
2120,25540,"Hartford-West Hartford-East Hartford, CT Metro Area",Rail,2014,27,31,58,0,
2121,25540,"Hartford-West Hartford-East Hartford, CT Metro Area",Rail,2015,111,47,158,0,
2122,25540,"Hartford-West Hartford-East Hartford, CT Metro Area",Rail,2016,75,21,96,0,
2123,25540,"Hartford-West Hartford-East Hartford, CT Metro Area",Rail,2017,49,36,85,0,
2124,25540,"Hartford-West Hartford-East Hartford, CT Metro Area",Rail,2018,57,4,61,0,
2125,25860,"Hickory-Lenoir-Morganton, NC Metro Area",Bus,2002,0,0,0,1,Not reported
2126,25860,"Hickory-Lenoir-Morganton, NC Metro Area",Bus,2003,0,0,0,1,Not reported
2127,25860,"Hickory-Lenoir-Morganton, NC Metro Area",Bus,2004,0,0,0,1,Not reported
2128,25860,"Hickory-Lenoir-Morganton, NC Metro Area",Bus,2005,0,0,0,1,Not reported
2129,25860,"Hickory-Lenoir-Morganton, NC Metro Area",Bus,2006,0,0,0,1,Not reported
2130,25860,"Hickory-Lenoir-Morganton, NC Metro Area",Bus,2007,0,0,0,1,Not reported
2131,25860,"Hickory-Lenoir-Morganton, NC Metro Area",Bus,2008,0,0,0,1,Not reported
2132,25860,"Hickory-Lenoir-Morganton, NC Metro Area",Bus,2009,19,3,22,0,
2133,25860,"Hickory-Lenoir-Morganton, NC Metro Area",Bus,2010,18,6,24,0,
2134,25860,"Hickory-Lenoir-Morganton, NC Metro Area",Bus,2011,8,3,11,0,
2135,25860,"Hickory-Lenoir-Morganton, NC Metro Area",Bus,2012,7,16,23,0,
2136,25860,"Hickory-Lenoir-Morganton, NC Metro Area",Bus,2013,7,12,19,0,
2137,25860,"Hickory-Lenoir-Morganton, NC Metro Area",Bus,2014,12,1,13,0,
2138,25860,"Hickory-Lenoir-Morganton, NC Metro Area",Bus,2015,5,1,6,0,
2139,25860,"Hickory-Lenoir-Morganton, NC Metro Area",Bus,2016,6,1,7,0,
2140,25860,"Hickory-Lenoir-Morganton, NC Metro Area",Bus,2017,9,1,10,0,
2141,25860,"Hickory-Lenoir-Morganton, NC Metro Area",Bus,2018,25,6,31,0,
1922,26100,"Holland-Grand Haven, MI Metro Area",Bus,2002,400,351,751,0,
2142,26100,"Holland-Grand Haven, MI Metro Area",Bus,2002,0,0,0,0,
1924,26100,"Holland-Grand Haven, MI Metro Area",Bus,2003,260,150,410,0,
2143,26100,"Holland-Grand Haven, MI Metro Area",Bus,2003,0,0,0,0,
1926,26100,"Holland-Grand Haven, MI Metro Area",Bus,2004,639,377,1016,0,
2144,26100,"Holland-Grand Haven, MI Metro Area",Bus,2004,0,0,0,0,
1928,26100,"Holland-Grand Haven, MI Metro Area",Bus,2005,1088,336,1424,0,
2145,26100,"Holland-Grand Haven, MI Metro Area",Bus,2005,0,0,0,0,
1930,26100,"Holland-Grand Haven, MI Metro Area",Bus,2006,1205,376,1581,0,
2146,26100,"Holland-Grand Haven, MI Metro Area",Bus,2006,0,0,0,0,
1932,26100,"Holland-Grand Haven, MI Metro Area",Bus,2007,364,961,1325,0,
2147,26100,"Holland-Grand Haven, MI Metro Area",Bus,2007,0,0,0,0,
1934,26100,"Holland-Grand Haven, MI Metro Area",Bus,2008,126,865,991,0,
2148,26100,"Holland-Grand Haven, MI Metro Area",Bus,2008,0,0,0,0,
1936,26100,"Holland-Grand Haven, MI Metro Area",Bus,2009,109,1003,1112,0,
2149,26100,"Holland-Grand Haven, MI Metro Area",Bus,2009,48,57,105,0,
1938,26100,"Holland-Grand Haven, MI Metro Area",Bus,2010,144,691,835,0,
2150,26100,"Holland-Grand Haven, MI Metro Area",Bus,2010,68,37,105,0,
1940,26100,"Holland-Grand Haven, MI Metro Area",Bus,2011,151,897,1048,0,
2151,26100,"Holland-Grand Haven, MI Metro Area",Bus,2011,26,61,87,0,
1942,26100,"Holland-Grand Haven, MI Metro Area",Bus,2012,115,1051,1166,0,
2152,26100,"Holland-Grand Haven, MI Metro Area",Bus,2012,17,72,89,0,
1944,26100,"Holland-Grand Haven, MI Metro Area",Bus,2013,390,1448,1838,0,
2153,26100,"Holland-Grand Haven, MI Metro Area",Bus,2013,22,88,110,0,
1946,26100,"Holland-Grand Haven, MI Metro Area",Bus,2014,682,1295,1977,0,
2154,26100,"Holland-Grand Haven, MI Metro Area",Bus,2014,14,90,104,0,
1948,26100,"Holland-Grand Haven, MI Metro Area",Bus,2015,197,1900,2097,0,
2155,26100,"Holland-Grand Haven, MI Metro Area",Bus,2015,7,113,120,0,
1950,26100,"Holland-Grand Haven, MI Metro Area",Bus,2016,270,669,939,0,
2156,26100,"Holland-Grand Haven, MI Metro Area",Bus,2016,22,83,105,0,
1952,26100,"Holland-Grand Haven, MI Metro Area",Bus,2017,95,523,618,0,
2157,26100,"Holland-Grand Haven, MI Metro Area",Bus,2017,26,48,74,0,
1954,26100,"Holland-Grand Haven, MI Metro Area",Bus,2018,262,313,575,0,
2158,26100,"Holland-Grand Haven, MI Metro Area",Bus,2018,35,23,58,0,
1190,26420,"Houston-Sugar Land-Baytown, TX Metro Area",Bus,2002,0,0,0,0,
2159,26420,"Houston-Sugar Land-Baytown, TX Metro Area",Bus,2002,4432,3635,8067,0,
5066,26420,"Houston-Sugar Land-Baytown, TX Metro Area",Bus,2002,0,0,0,0,
1191,26420,"Houston-Sugar Land-Baytown, TX Metro Area",Bus,2003,0,0,0,0,
2160,26420,"Houston-Sugar Land-Baytown, TX Metro Area",Bus,2003,7394,6561,13955,0,
5067,26420,"Houston-Sugar Land-Baytown, TX Metro Area",Bus,2003,0,0,0,0,
1192,26420,"Houston-Sugar Land-Baytown, TX Metro Area",Bus,2004,0,0,0,0,
2161,26420,"Houston-Sugar Land-Baytown, TX Metro Area",Bus,2004,7993,5008,13001,0,
5068,26420,"Houston-Sugar Land-Baytown, TX Metro Area",Bus,2004,0,0,0,0,
1193,26420,"Houston-Sugar Land-Baytown, TX Metro Area",Bus,2005,0,0,0,0,
2162,26420,"Houston-Sugar Land-Baytown, TX Metro Area",Bus,2005,8285,3070,11355,0,
5069,26420,"Houston-Sugar Land-Baytown, TX Metro Area",Bus,2005,0,0,0,0,
1194,26420,"Houston-Sugar Land-Baytown, TX Metro Area",Bus,2006,0,0,0,0,
2163,26420,"Houston-Sugar Land-Baytown, TX Metro Area",Bus,2006,6976,3162,10138,0,
5070,26420,"Houston-Sugar Land-Baytown, TX Metro Area",Bus,2006,0,0,0,0,
1195,26420,"Houston-Sugar Land-Baytown, TX Metro Area",Bus,2007,0,0,0,0,
2164,26420,"Houston-Sugar Land-Baytown, TX Metro Area",Bus,2007,6258,3401,9659,0,
5071,26420,"Houston-Sugar Land-Baytown, TX Metro Area",Bus,2007,0,0,0,0,
1196,26420,"Houston-Sugar Land-Baytown, TX Metro Area",Bus,2008,0,0,0,0,
2165,26420,"Houston-Sugar Land-Baytown, TX Metro Area",Bus,2008,6656,4056,10712,0,
5072,26420,"Houston-Sugar Land-Baytown, TX Metro Area",Bus,2008,0,0,0,0,
1197,26420,"Houston-Sugar Land-Baytown, TX Metro Area",Bus,2009,0,0,0,0,
2166,26420,"Houston-Sugar Land-Baytown, TX Metro Area",Bus,2009,6114,2607,8721,0,
5073,26420,"Houston-Sugar Land-Baytown, TX Metro Area",Bus,2009,2,1,3,0,
1198,26420,"Houston-Sugar Land-Baytown, TX Metro Area",Bus,2010,0,0,0,0,
2167,26420,"Houston-Sugar Land-Baytown, TX Metro Area",Bus,2010,5656,2355,8011,0,
5074,26420,"Houston-Sugar Land-Baytown, TX Metro Area",Bus,2010,3,13,16,0,
1199,26420,"Houston-Sugar Land-Baytown, TX Metro Area",Bus,2011,0,0,0,0,
2168,26420,"Houston-Sugar Land-Baytown, TX Metro Area",Bus,2011,4740,2377,7117,0,
5075,26420,"Houston-Sugar Land-Baytown, TX Metro Area",Bus,2011,7,25,32,0,
1200,26420,"Houston-Sugar Land-Baytown, TX Metro Area",Bus,2012,0,0,0,0,
2169,26420,"Houston-Sugar Land-Baytown, TX Metro Area",Bus,2012,4375,1937,6312,0,
5076,26420,"Houston-Sugar Land-Baytown, TX Metro Area",Bus,2012,7,22,29,0,
1201,26420,"Houston-Sugar Land-Baytown, TX Metro Area",Bus,2013,0,0,0,0,
2170,26420,"Houston-Sugar Land-Baytown, TX Metro Area",Bus,2013,4433,1884,6317,0,
5077,26420,"Houston-Sugar Land-Baytown, TX Metro Area",Bus,2013,8,19,27,0,
1202,26420,"Houston-Sugar Land-Baytown, TX Metro Area",Bus,2014,0,0,0,0,
2171,26420,"Houston-Sugar Land-Baytown, TX Metro Area",Bus,2014,4015,1590,5605,0,
5078,26420,"Houston-Sugar Land-Baytown, TX Metro Area",Bus,2014,15,25,40,0,
1203,26420,"Houston-Sugar Land-Baytown, TX Metro Area",Bus,2015,0,33,33,0,
2172,26420,"Houston-Sugar Land-Baytown, TX Metro Area",Bus,2015,4071,1654,5725,0,
5079,26420,"Houston-Sugar Land-Baytown, TX Metro Area",Bus,2015,14,28,42,0,
1204,26420,"Houston-Sugar Land-Baytown, TX Metro Area",Bus,2016,0,13,13,0,
2173,26420,"Houston-Sugar Land-Baytown, TX Metro Area",Bus,2016,4056,1905,5961,0,
5080,26420,"Houston-Sugar Land-Baytown, TX Metro Area",Bus,2016,24,29,53,0,
1205,26420,"Houston-Sugar Land-Baytown, TX Metro Area",Bus,2017,0,7,7,0,
2174,26420,"Houston-Sugar Land-Baytown, TX Metro Area",Bus,2017,3809,1597,5406,0,
5081,26420,"Houston-Sugar Land-Baytown, TX Metro Area",Bus,2017,14,34,48,0,
1206,26420,"Houston-Sugar Land-Baytown, TX Metro Area",Bus,2018,21,23,44,0,
2175,26420,"Houston-Sugar Land-Baytown, TX Metro Area",Bus,2018,3755,1513,5268,0,
5082,26420,"Houston-Sugar Land-Baytown, TX Metro Area",Bus,2018,41,58,99,0,
2176,26420,"Houston-Sugar Land-Baytown, TX Metro Area",Rail,2002,0,0,0,0,
2177,26420,"Houston-Sugar Land-Baytown, TX Metro Area",Rail,2003,0,0,0,0,
2178,26420,"Houston-Sugar Land-Baytown, TX Metro Area",Rail,2004,11,108,119,0,
2179,26420,"Houston-Sugar Land-Baytown, TX Metro Area",Rail,2005,5,117,122,0,
2180,26420,"Houston-Sugar Land-Baytown, TX Metro Area",Rail,2006,11,99,110,0,
2181,26420,"Houston-Sugar Land-Baytown, TX Metro Area",Rail,2007,16,84,100,0,
2182,26420,"Houston-Sugar Land-Baytown, TX Metro Area",Rail,2008,4,87,91,0,
2183,26420,"Houston-Sugar Land-Baytown, TX Metro Area",Rail,2009,8,79,87,0,
2184,26420,"Houston-Sugar Land-Baytown, TX Metro Area",Rail,2010,19,33,52,0,
2185,26420,"Houston-Sugar Land-Baytown, TX Metro Area",Rail,2011,8,28,36,0,
2186,26420,"Houston-Sugar Land-Baytown, TX Metro Area",Rail,2012,8,26,34,0,
2187,26420,"Houston-Sugar Land-Baytown, TX Metro Area",Rail,2013,17,32,49,0,
2188,26420,"Houston-Sugar Land-Baytown, TX Metro Area",Rail,2014,28,30,58,0,
2189,26420,"Houston-Sugar Land-Baytown, TX Metro Area",Rail,2015,28,42,70,0,
2190,26420,"Houston-Sugar Land-Baytown, TX Metro Area",Rail,2016,33,41,74,0,
2191,26420,"Houston-Sugar Land-Baytown, TX Metro Area",Rail,2017,29,31,60,0,
2192,26420,"Houston-Sugar Land-Baytown, TX Metro Area",Rail,2018,20,26,46,0,
2194,26580,"Huntington-Ashland, WV-KY-OH Metro Area",Bus,2002,0,403,403,0,
2196,26580,"Huntington-Ashland, WV-KY-OH Metro Area",Bus,2003,0,346,346,0,
2198,26580,"Huntington-Ashland, WV-KY-OH Metro Area",Bus,2004,2,326,328,0,
2200,26580,"Huntington-Ashland, WV-KY-OH Metro Area",Bus,2005,0,269,269,0,
2202,26580,"Huntington-Ashland, WV-KY-OH Metro Area",Bus,2006,0,198,198,0,
2204,26580,"Huntington-Ashland, WV-KY-OH Metro Area",Bus,2007,0,352,352,0,
2206,26580,"Huntington-Ashland, WV-KY-OH Metro Area",Bus,2008,0,454,454,0,
2208,26580,"Huntington-Ashland, WV-KY-OH Metro Area",Bus,2009,2,261,263,0,
2210,26580,"Huntington-Ashland, WV-KY-OH Metro Area",Bus,2010,0,217,217,0,
2212,26580,"Huntington-Ashland, WV-KY-OH Metro Area",Bus,2011,4,236,240,0,
2214,26580,"Huntington-Ashland, WV-KY-OH Metro Area",Bus,2012,8,337,345,0,
2216,26580,"Huntington-Ashland, WV-KY-OH Metro Area",Bus,2013,5,296,301,0,
2218,26580,"Huntington-Ashland, WV-KY-OH Metro Area",Bus,2014,92,24,116,0,
2220,26580,"Huntington-Ashland, WV-KY-OH Metro Area",Bus,2015,2,224,226,0,
2222,26580,"Huntington-Ashland, WV-KY-OH Metro Area",Bus,2016,2,275,277,0,
2224,26580,"Huntington-Ashland, WV-KY-OH Metro Area",Bus,2017,2,356,358,0,
2226,26580,"Huntington-Ashland, WV-KY-OH Metro Area",Bus,2018,12,296,308,0,
2227,26620,"Huntsville, AL Metro Area",Bus,2002,15,7,22,0,
2228,26620,"Huntsville, AL Metro Area",Bus,2003,42,71,113,0,
2229,26620,"Huntsville, AL Metro Area",Bus,2004,53,51,104,0,
2230,26620,"Huntsville, AL Metro Area",Bus,2005,65,100,165,0,
2231,26620,"Huntsville, AL Metro Area",Bus,2006,19,244,263,0,
2232,26620,"Huntsville, AL Metro Area",Bus,2007,16,233,249,0,
2233,26620,"Huntsville, AL Metro Area",Bus,2008,14,185,199,0,
2234,26620,"Huntsville, AL Metro Area",Bus,2009,14,194,208,0,
2235,26620,"Huntsville, AL Metro Area",Bus,2010,19,219,238,0,
2236,26620,"Huntsville, AL Metro Area",Bus,2011,56,151,207,0,
2237,26620,"Huntsville, AL Metro Area",Bus,2012,31,126,157,0,
2238,26620,"Huntsville, AL Metro Area",Bus,2013,24,130,154,0,
2239,26620,"Huntsville, AL Metro Area",Bus,2014,22,158,180,0,
2240,26620,"Huntsville, AL Metro Area",Bus,2015,20,144,164,0,
2241,26620,"Huntsville, AL Metro Area",Bus,2016,35,162,197,0,
2242,26620,"Huntsville, AL Metro Area",Bus,2017,63,148,211,0,
2243,26620,"Huntsville, AL Metro Area",Bus,2018,87,124,211,0,
2244,26900,"Indianapolis-Carmel, IN Metro Area",Bus,2002,473,0,473,0,
2245,26900,"Indianapolis-Carmel, IN Metro Area",Bus,2003,579,0,579,0,
2246,26900,"Indianapolis-Carmel, IN Metro Area",Bus,2004,315,0,315,0,
2247,26900,"Indianapolis-Carmel, IN Metro Area",Bus,2005,351,0,351,0,
2248,26900,"Indianapolis-Carmel, IN Metro Area",Bus,2006,311,8,319,0,
2249,26900,"Indianapolis-Carmel, IN Metro Area",Bus,2007,318,78,396,0,
2250,26900,"Indianapolis-Carmel, IN Metro Area",Bus,2008,315,93,408,0,
2251,26900,"Indianapolis-Carmel, IN Metro Area",Bus,2009,368,44,412,0,
2252,26900,"Indianapolis-Carmel, IN Metro Area",Bus,2010,334,40,374,0,
2253,26900,"Indianapolis-Carmel, IN Metro Area",Bus,2011,2198,561,2759,0,
2254,26900,"Indianapolis-Carmel, IN Metro Area",Bus,2012,2011,751,2762,0,
2255,26900,"Indianapolis-Carmel, IN Metro Area",Bus,2013,1748,498,2246,0,
2256,26900,"Indianapolis-Carmel, IN Metro Area",Bus,2014,1476,344,1820,0,
2257,26900,"Indianapolis-Carmel, IN Metro Area",Bus,2015,1453,378,1831,0,
2258,26900,"Indianapolis-Carmel, IN Metro Area",Bus,2016,1578,378,1956,0,
2259,26900,"Indianapolis-Carmel, IN Metro Area",Bus,2017,1225,43,1268,0,
2260,26900,"Indianapolis-Carmel, IN Metro Area",Bus,2018,1437,393,1830,0,
2278,26980,"Iowa City, IA Metro Area",Bus,2002,22,94,116,0,
2279,26980,"Iowa City, IA Metro Area",Bus,2003,30,266,296,0,
2280,26980,"Iowa City, IA Metro Area",Bus,2004,49,81,130,0,
2281,26980,"Iowa City, IA Metro Area",Bus,2005,44,110,154,0,
2282,26980,"Iowa City, IA Metro Area",Bus,2006,49,241,290,0,
2283,26980,"Iowa City, IA Metro Area",Bus,2007,56,258,314,0,
2284,26980,"Iowa City, IA Metro Area",Bus,2008,107,288,395,0,
2285,26980,"Iowa City, IA Metro Area",Bus,2009,86,138,224,0,
2286,26980,"Iowa City, IA Metro Area",Bus,2010,56,114,170,0,
2287,26980,"Iowa City, IA Metro Area",Bus,2011,52,106,158,0,
2288,26980,"Iowa City, IA Metro Area",Bus,2012,51,120,171,0,
2289,26980,"Iowa City, IA Metro Area",Bus,2013,50,140,190,0,
2290,26980,"Iowa City, IA Metro Area",Bus,2014,33,118,151,0,
2291,26980,"Iowa City, IA Metro Area",Bus,2015,36,123,159,0,
2292,26980,"Iowa City, IA Metro Area",Bus,2016,35,124,159,0,
2293,26980,"Iowa City, IA Metro Area",Bus,2017,45,154,199,0,
2294,26980,"Iowa City, IA Metro Area",Bus,2018,41,184,225,0,
2295,27060,"Ithaca, NY Metro Area",Bus,2002,320,112,432,0,
2296,27060,"Ithaca, NY Metro Area",Bus,2003,151,376,527,0,
2297,27060,"Ithaca, NY Metro Area",Bus,2004,375,179,554,0,
2298,27060,"Ithaca, NY Metro Area",Bus,2005,375,300,675,0,
2299,27060,"Ithaca, NY Metro Area",Bus,2006,326,307,633,0,
2300,27060,"Ithaca, NY Metro Area",Bus,2007,174,451,625,0,
2301,27060,"Ithaca, NY Metro Area",Bus,2008,183,240,423,0,
2302,27060,"Ithaca, NY Metro Area",Bus,2009,167,305,472,0,
2303,27060,"Ithaca, NY Metro Area",Bus,2010,121,391,512,0,
2304,27060,"Ithaca, NY Metro Area",Bus,2011,145,323,468,0,
2305,27060,"Ithaca, NY Metro Area",Bus,2012,196,186,382,0,
2306,27060,"Ithaca, NY Metro Area",Bus,2013,214,169,383,0,
2307,27060,"Ithaca, NY Metro Area",Bus,2014,306,204,510,0,
2308,27060,"Ithaca, NY Metro Area",Bus,2015,221,168,389,0,
2309,27060,"Ithaca, NY Metro Area",Bus,2016,140,369,509,0,
2310,27060,"Ithaca, NY Metro Area",Bus,2017,43,253,296,0,
2311,27060,"Ithaca, NY Metro Area",Bus,2018,64,324,388,0,
2312,27100,"Jackson, MI Metro Area",Bus,2002,103,111,214,0,
2313,27100,"Jackson, MI Metro Area",Bus,2003,236,104,340,0,
2314,27100,"Jackson, MI Metro Area",Bus,2004,49,18,67,0,
2315,27100,"Jackson, MI Metro Area",Bus,2005,35,8,43,0,
2316,27100,"Jackson, MI Metro Area",Bus,2006,182,90,272,0,
2317,27100,"Jackson, MI Metro Area",Bus,2007,31,12,43,0,
2318,27100,"Jackson, MI Metro Area",Bus,2008,31,13,44,0,
2319,27100,"Jackson, MI Metro Area",Bus,2009,19,3,22,0,
2320,27100,"Jackson, MI Metro Area",Bus,2010,14,2,16,0,
2321,27100,"Jackson, MI Metro Area",Bus,2011,61,42,103,0,
2322,27100,"Jackson, MI Metro Area",Bus,2012,41,38,79,0,
2323,27100,"Jackson, MI Metro Area",Bus,2013,63,33,96,0,
2324,27100,"Jackson, MI Metro Area",Bus,2014,91,47,138,0,
2325,27100,"Jackson, MI Metro Area",Bus,2015,86,50,136,0,
2326,27100,"Jackson, MI Metro Area",Bus,2016,113,28,141,0,
2327,27100,"Jackson, MI Metro Area",Bus,2017,158,49,207,0,
2328,27100,"Jackson, MI Metro Area",Bus,2018,54,150,204,0,
2329,27140,"Jackson, MS Metro Area",Bus,2002,257,76,333,0,
2330,27140,"Jackson, MS Metro Area",Bus,2003,297,42,339,0,
2331,27140,"Jackson, MS Metro Area",Bus,2004,247,27,274,0,
2332,27140,"Jackson, MS Metro Area",Bus,2005,359,47,406,0,
2333,27140,"Jackson, MS Metro Area",Bus,2006,434,26,460,0,
2334,27140,"Jackson, MS Metro Area",Bus,2007,390,25,415,0,
2335,27140,"Jackson, MS Metro Area",Bus,2008,310,71,381,0,
2336,27140,"Jackson, MS Metro Area",Bus,2009,341,23,364,0,
2337,27140,"Jackson, MS Metro Area",Bus,2010,300,17,317,0,
2338,27140,"Jackson, MS Metro Area",Bus,2011,320,9,329,0,
2339,27140,"Jackson, MS Metro Area",Bus,2012,25,51,76,0,
2340,27140,"Jackson, MS Metro Area",Bus,2013,93,108,201,0,
2341,27140,"Jackson, MS Metro Area",Bus,2014,103,188,291,0,
2342,27140,"Jackson, MS Metro Area",Bus,2015,6,360,366,0,
2343,27140,"Jackson, MS Metro Area",Bus,2016,14,1185,1199,0,
2344,27140,"Jackson, MS Metro Area",Bus,2017,8,1311,1319,0,
2345,27140,"Jackson, MS Metro Area",Bus,2018,13,1422,1435,0,
2346,27180,"Jackson, TN Metro Area",Bus,2002,45,84,129,0,
2347,27180,"Jackson, TN Metro Area",Bus,2003,44,79,123,0,
2348,27180,"Jackson, TN Metro Area",Bus,2004,51,43,94,0,
2349,27180,"Jackson, TN Metro Area",Bus,2005,36,63,99,0,
2350,27180,"Jackson, TN Metro Area",Bus,2006,48,112,160,0,
2351,27180,"Jackson, TN Metro Area",Bus,2007,41,113,154,0,
2352,27180,"Jackson, TN Metro Area",Bus,2008,58,133,191,0,
2353,27180,"Jackson, TN Metro Area",Bus,2009,66,125,191,0,
2354,27180,"Jackson, TN Metro Area",Bus,2010,69,91,160,0,
2355,27180,"Jackson, TN Metro Area",Bus,2011,77,79,156,0,
2356,27180,"Jackson, TN Metro Area",Bus,2012,77,82,159,0,
2357,27180,"Jackson, TN Metro Area",Bus,2013,70,65,135,0,
2358,27180,"Jackson, TN Metro Area",Bus,2014,87,70,157,0,
2359,27180,"Jackson, TN Metro Area",Bus,2015,67,98,165,0,
2360,27180,"Jackson, TN Metro Area",Bus,2016,78,67,145,0,
2361,27180,"Jackson, TN Metro Area",Bus,2017,96,82,178,0,
2362,27180,"Jackson, TN Metro Area",Bus,2018,94,62,156,0,
2363,27260,"Jacksonville, FL Metro Area",Bus,2002,637,180,817,0,
2364,27260,"Jacksonville, FL Metro Area",Bus,2003,854,145,999,0,
2365,27260,"Jacksonville, FL Metro Area",Bus,2004,625,94,719,0,
2366,27260,"Jacksonville, FL Metro Area",Bus,2005,440,67,507,0,
2367,27260,"Jacksonville, FL Metro Area",Bus,2006,524,75,599,0,
2368,27260,"Jacksonville, FL Metro Area",Bus,2007,591,105,696,0,
2369,27260,"Jacksonville, FL Metro Area",Bus,2008,879,271,1150,0,
2370,27260,"Jacksonville, FL Metro Area",Bus,2009,782,332,1114,0,
2371,27260,"Jacksonville, FL Metro Area",Bus,2010,714,332,1046,0,
2372,27260,"Jacksonville, FL Metro Area",Bus,2011,617,384,1001,0,
2373,27260,"Jacksonville, FL Metro Area",Bus,2012,370,359,729,0,
2374,27260,"Jacksonville, FL Metro Area",Bus,2013,169,232,401,0,
2375,27260,"Jacksonville, FL Metro Area",Bus,2014,80,528,608,0,
2376,27260,"Jacksonville, FL Metro Area",Bus,2015,92,571,663,0,
2377,27260,"Jacksonville, FL Metro Area",Bus,2016,90,699,789,0,
2378,27260,"Jacksonville, FL Metro Area",Bus,2017,94,714,808,0,
2379,27260,"Jacksonville, FL Metro Area",Bus,2018,126,691,817,0,
2380,27260,"Jacksonville, FL Metro Area",Rail,2002,15,17,32,0,
2381,27260,"Jacksonville, FL Metro Area",Rail,2003,30,27,57,0,
2382,27260,"Jacksonville, FL Metro Area",Rail,2004,32,27,59,0,
2383,27260,"Jacksonville, FL Metro Area",Rail,2005,20,7,27,0,
2384,27260,"Jacksonville, FL Metro Area",Rail,2006,22,9,31,0,
2385,27260,"Jacksonville, FL Metro Area",Rail,2007,7,3,10,0,
2386,27260,"Jacksonville, FL Metro Area",Rail,2008,7,1,8,0,
2387,27260,"Jacksonville, FL Metro Area",Rail,2009,10,12,22,0,
2388,27260,"Jacksonville, FL Metro Area",Rail,2010,16,13,29,0,
2389,27260,"Jacksonville, FL Metro Area",Rail,2011,6,20,26,0,
2390,27260,"Jacksonville, FL Metro Area",Rail,2012,11,8,19,0,
2391,27260,"Jacksonville, FL Metro Area",Rail,2013,7,4,11,0,
2392,27260,"Jacksonville, FL Metro Area",Rail,2014,8,4,12,0,
2393,27260,"Jacksonville, FL Metro Area",Rail,2015,10,12,22,0,
2394,27260,"Jacksonville, FL Metro Area",Rail,2016,5,5,10,0,
2395,27260,"Jacksonville, FL Metro Area",Rail,2017,3,5,8,0,
2396,27260,"Jacksonville, FL Metro Area",Rail,2018,15,2,17,0,
2397,27780,"Johnstown, PA Metro Area",Bus,2002,88,13,101,0,
2398,27780,"Johnstown, PA Metro Area",Bus,2003,81,88,169,0,
2399,27780,"Johnstown, PA Metro Area",Bus,2004,7,18,25,0,
2400,27780,"Johnstown, PA Metro Area",Bus,2005,8,16,24,0,
2401,27780,"Johnstown, PA Metro Area",Bus,2006,25,32,57,0,
2402,27780,"Johnstown, PA Metro Area",Bus,2007,57,21,78,0,
2403,27780,"Johnstown, PA Metro Area",Bus,2008,53,27,80,0,
2404,27780,"Johnstown, PA Metro Area",Bus,2009,64,18,82,0,
2405,27780,"Johnstown, PA Metro Area",Bus,2010,107,36,143,0,
2406,27780,"Johnstown, PA Metro Area",Bus,2011,175,11,186,0,
2407,27780,"Johnstown, PA Metro Area",Bus,2012,173,14,187,0,
2408,27780,"Johnstown, PA Metro Area",Bus,2013,129,63,192,0,
2409,27780,"Johnstown, PA Metro Area",Bus,2014,62,122,184,0,
2410,27780,"Johnstown, PA Metro Area",Bus,2015,233,299,532,0,
2411,27780,"Johnstown, PA Metro Area",Bus,2016,201,274,475,0,
2412,27780,"Johnstown, PA Metro Area",Bus,2017,123,365,488,0,
2413,27780,"Johnstown, PA Metro Area",Bus,2018,276,191,467,0,
2414,27780,"Johnstown, PA Metro Area",Rail,2002,0,0,0,0,
2415,27780,"Johnstown, PA Metro Area",Rail,2003,0,1,1,0,
2416,27780,"Johnstown, PA Metro Area",Rail,2004,0,1,1,0,
2417,27780,"Johnstown, PA Metro Area",Rail,2005,0,1,1,0,
2418,27780,"Johnstown, PA Metro Area",Rail,2006,0,1,1,0,
2419,27780,"Johnstown, PA Metro Area",Rail,2007,0,1,1,0,
2420,27780,"Johnstown, PA Metro Area",Rail,2008,0,0,0,0,
2421,27780,"Johnstown, PA Metro Area",Rail,2009,0,2,2,0,
2422,27780,"Johnstown, PA Metro Area",Rail,2010,1,1,2,0,
2423,27780,"Johnstown, PA Metro Area",Rail,2011,1,1,2,0,
2424,27780,"Johnstown, PA Metro Area",Rail,2012,1,2,3,0,
2425,27780,"Johnstown, PA Metro Area",Rail,2013,4,0,4,0,
2426,27780,"Johnstown, PA Metro Area",Rail,2014,6,0,6,0,
2427,27780,"Johnstown, PA Metro Area",Rail,2015,9,0,9,0,
2428,27780,"Johnstown, PA Metro Area",Rail,2016,8,0,8,0,
2429,27780,"Johnstown, PA Metro Area",Rail,2017,12,0,12,0,
2430,27780,"Johnstown, PA Metro Area",Rail,2018,0,0,0,0,
2431,28020,"Kalamazoo-Portage, MI Metro Area",Bus,2002,507,423,930,0,
2432,28020,"Kalamazoo-Portage, MI Metro Area",Bus,2003,207,625,832,0,
2433,28020,"Kalamazoo-Portage, MI Metro Area",Bus,2004,296,612,908,0,
2434,28020,"Kalamazoo-Portage, MI Metro Area",Bus,2005,362,545,907,0,
2435,28020,"Kalamazoo-Portage, MI Metro Area",Bus,2006,206,329,535,0,
2436,28020,"Kalamazoo-Portage, MI Metro Area",Bus,2007,273,511,784,0,
2437,28020,"Kalamazoo-Portage, MI Metro Area",Bus,2008,266,435,701,0,
2438,28020,"Kalamazoo-Portage, MI Metro Area",Bus,2009,98,661,759,0,
2439,28020,"Kalamazoo-Portage, MI Metro Area",Bus,2010,35,541,576,0,
2440,28020,"Kalamazoo-Portage, MI Metro Area",Bus,2011,36,629,665,0,
2441,28020,"Kalamazoo-Portage, MI Metro Area",Bus,2012,39,592,631,0,
2442,28020,"Kalamazoo-Portage, MI Metro Area",Bus,2013,24,503,527,0,
2443,28020,"Kalamazoo-Portage, MI Metro Area",Bus,2014,57,438,495,0,
2444,28020,"Kalamazoo-Portage, MI Metro Area",Bus,2015,29,522,551,0,
2445,28020,"Kalamazoo-Portage, MI Metro Area",Bus,2016,33,673,706,0,
2446,28020,"Kalamazoo-Portage, MI Metro Area",Bus,2017,19,742,761,0,
2447,28020,"Kalamazoo-Portage, MI Metro Area",Bus,2018,35,915,950,0,
2448,28100,"Kankakee-Bradley, IL Metro Area",Bus,2002,0,0,0,1,Not reported
2449,28100,"Kankakee-Bradley, IL Metro Area",Bus,2003,0,0,0,1,Not reported
2450,28100,"Kankakee-Bradley, IL Metro Area",Bus,2004,0,0,0,1,Not reported
2451,28100,"Kankakee-Bradley, IL Metro Area",Bus,2005,0,0,0,1,Not reported
2452,28100,"Kankakee-Bradley, IL Metro Area",Bus,2006,0,0,0,1,Not reported
2453,28100,"Kankakee-Bradley, IL Metro Area",Bus,2007,0,0,0,1,Not reported
2454,28100,"Kankakee-Bradley, IL Metro Area",Bus,2008,25,294,319,0,
2455,28100,"Kankakee-Bradley, IL Metro Area",Bus,2009,112,320,432,0,
2456,28100,"Kankakee-Bradley, IL Metro Area",Bus,2010,134,388,522,0,
2457,28100,"Kankakee-Bradley, IL Metro Area",Bus,2011,153,402,555,0,
2458,28100,"Kankakee-Bradley, IL Metro Area",Bus,2012,140,389,529,0,
2459,28100,"Kankakee-Bradley, IL Metro Area",Bus,2013,138,366,504,0,
2460,28100,"Kankakee-Bradley, IL Metro Area",Bus,2014,123,361,484,0,
2461,28100,"Kankakee-Bradley, IL Metro Area",Bus,2015,133,385,518,0,
2462,28100,"Kankakee-Bradley, IL Metro Area",Bus,2016,133,563,696,0,
2463,28100,"Kankakee-Bradley, IL Metro Area",Bus,2017,247,489,736,0,
2464,28100,"Kankakee-Bradley, IL Metro Area",Bus,2018,257,549,806,0,
2465,28140,"Kansas City, MO-KS Metro Area",Bus,2002,872,900,1772,0,
2466,28140,"Kansas City, MO-KS Metro Area",Bus,2003,687,295,982,0,
2467,28140,"Kansas City, MO-KS Metro Area",Bus,2004,824,378,1202,0,
2468,28140,"Kansas City, MO-KS Metro Area",Bus,2005,750,243,993,0,
2469,28140,"Kansas City, MO-KS Metro Area",Bus,2006,512,110,622,0,
2470,28140,"Kansas City, MO-KS Metro Area",Bus,2007,689,51,740,0,
2471,28140,"Kansas City, MO-KS Metro Area",Bus,2008,630,105,735,0,
2472,28140,"Kansas City, MO-KS Metro Area",Bus,2009,591,681,1272,0,
2473,28140,"Kansas City, MO-KS Metro Area",Bus,2010,656,110,766,0,
2474,28140,"Kansas City, MO-KS Metro Area",Bus,2011,599,75,674,0,
2475,28140,"Kansas City, MO-KS Metro Area",Bus,2012,583,69,652,0,
2476,28140,"Kansas City, MO-KS Metro Area",Bus,2013,571,99,670,0,
2477,28140,"Kansas City, MO-KS Metro Area",Bus,2014,570,87,657,0,
2478,28140,"Kansas City, MO-KS Metro Area",Bus,2015,751,138,889,0,
2479,28140,"Kansas City, MO-KS Metro Area",Bus,2016,678,157,835,0,
2480,28140,"Kansas City, MO-KS Metro Area",Bus,2017,693,127,820,0,
2481,28140,"Kansas City, MO-KS Metro Area",Bus,2018,601,148,749,0,
2482,28140,"Kansas City, MO-KS Metro Area",Rail,2002,0,0,0,1,Not reported
2483,28140,"Kansas City, MO-KS Metro Area",Rail,2003,0,0,0,1,Not reported
2484,28140,"Kansas City, MO-KS Metro Area",Rail,2004,0,0,0,1,Not reported
2485,28140,"Kansas City, MO-KS Metro Area",Rail,2005,0,0,0,1,Not reported
2486,28140,"Kansas City, MO-KS Metro Area",Rail,2006,0,0,0,1,Not reported
2487,28140,"Kansas City, MO-KS Metro Area",Rail,2007,0,0,0,1,Not reported
2488,28140,"Kansas City, MO-KS Metro Area",Rail,2008,0,0,0,1,Not reported
2489,28140,"Kansas City, MO-KS Metro Area",Rail,2009,0,0,0,1,Not reported
2490,28140,"Kansas City, MO-KS Metro Area",Rail,2010,0,0,0,1,Not reported
2491,28140,"Kansas City, MO-KS Metro Area",Rail,2011,0,0,0,1,Not reported
2492,28140,"Kansas City, MO-KS Metro Area",Rail,2012,0,0,0,1,Not reported
2493,28140,"Kansas City, MO-KS Metro Area",Rail,2013,0,0,0,1,Not reported
2494,28140,"Kansas City, MO-KS Metro Area",Rail,2014,0,0,0,1,Not reported
2495,28140,"Kansas City, MO-KS Metro Area",Rail,2015,0,0,0,1,Not reported
2496,28140,"Kansas City, MO-KS Metro Area",Rail,2016,0,0,0,1,Not reported
2497,28140,"Kansas City, MO-KS Metro Area",Rail,2017,0,0,0,1,Not reported
2498,28140,"Kansas City, MO-KS Metro Area",Rail,2018,0,0,0,1,Not reported
2499,28420,"Kennewick-Pasco-Richland, WA Metro Area",Bus,2002,237,12,249,0,
2500,28420,"Kennewick-Pasco-Richland, WA Metro Area",Bus,2003,248,13,261,0,
2501,28420,"Kennewick-Pasco-Richland, WA Metro Area",Bus,2004,0,0,0,1,Not reported
2502,28420,"Kennewick-Pasco-Richland, WA Metro Area",Bus,2005,206,10,216,0,
2503,28420,"Kennewick-Pasco-Richland, WA Metro Area",Bus,2006,182,9,191,0,
2504,28420,"Kennewick-Pasco-Richland, WA Metro Area",Bus,2007,149,7,156,0,
2505,28420,"Kennewick-Pasco-Richland, WA Metro Area",Bus,2008,144,8,152,0,
2506,28420,"Kennewick-Pasco-Richland, WA Metro Area",Bus,2009,84,4,88,0,
2507,28420,"Kennewick-Pasco-Richland, WA Metro Area",Bus,2010,82,4,86,0,
2508,28420,"Kennewick-Pasco-Richland, WA Metro Area",Bus,2011,81,3,84,0,
2509,28420,"Kennewick-Pasco-Richland, WA Metro Area",Bus,2012,24,17,41,0,
2510,28420,"Kennewick-Pasco-Richland, WA Metro Area",Bus,2013,35,2,37,0,
2511,28420,"Kennewick-Pasco-Richland, WA Metro Area",Bus,2014,29,1,30,0,
2512,28420,"Kennewick-Pasco-Richland, WA Metro Area",Bus,2015,31,0,31,0,
2513,28420,"Kennewick-Pasco-Richland, WA Metro Area",Bus,2016,87,87,174,0,
2514,28420,"Kennewick-Pasco-Richland, WA Metro Area",Bus,2017,62,116,178,0,
2515,28420,"Kennewick-Pasco-Richland, WA Metro Area",Bus,2018,72,71,143,0,
2550,28660,"Killeen-Temple-Fort Hood, TX Metro Area",Bus,2002,39,35,74,0,
2551,28660,"Killeen-Temple-Fort Hood, TX Metro Area",Bus,2003,99,121,220,0,
2552,28660,"Killeen-Temple-Fort Hood, TX Metro Area",Bus,2004,51,39,90,0,
2553,28660,"Killeen-Temple-Fort Hood, TX Metro Area",Bus,2005,39,49,88,0,
2554,28660,"Killeen-Temple-Fort Hood, TX Metro Area",Bus,2006,26,35,61,0,
2555,28660,"Killeen-Temple-Fort Hood, TX Metro Area",Bus,2007,27,43,70,0,
2556,28660,"Killeen-Temple-Fort Hood, TX Metro Area",Bus,2008,26,33,59,0,
2557,28660,"Killeen-Temple-Fort Hood, TX Metro Area",Bus,2009,61,35,96,0,
2558,28660,"Killeen-Temple-Fort Hood, TX Metro Area",Bus,2010,93,65,158,0,
2559,28660,"Killeen-Temple-Fort Hood, TX Metro Area",Bus,2011,77,78,155,0,
2560,28660,"Killeen-Temple-Fort Hood, TX Metro Area",Bus,2012,51,50,101,0,
2561,28660,"Killeen-Temple-Fort Hood, TX Metro Area",Bus,2013,139,50,189,0,
2562,28660,"Killeen-Temple-Fort Hood, TX Metro Area",Bus,2014,66,6,72,0,
2563,28660,"Killeen-Temple-Fort Hood, TX Metro Area",Bus,2015,94,22,116,0,
2564,28660,"Killeen-Temple-Fort Hood, TX Metro Area",Bus,2016,75,5,80,0,
2565,28660,"Killeen-Temple-Fort Hood, TX Metro Area",Bus,2017,49,5,54,0,
2566,28660,"Killeen-Temple-Fort Hood, TX Metro Area",Bus,2018,53,5,58,0,
2567,28940,"Knoxville, TN Metro Area",Bus,2002,397,339,736,0,
2568,28940,"Knoxville, TN Metro Area",Bus,2003,365,339,704,0,
2569,28940,"Knoxville, TN Metro Area",Bus,2004,479,351,830,0,
2570,28940,"Knoxville, TN Metro Area",Bus,2005,616,463,1079,0,
2571,28940,"Knoxville, TN Metro Area",Bus,2006,327,312,639,0,
2572,28940,"Knoxville, TN Metro Area",Bus,2007,166,254,420,0,
2573,28940,"Knoxville, TN Metro Area",Bus,2008,182,240,422,0,
2574,28940,"Knoxville, TN Metro Area",Bus,2009,151,250,401,0,
2575,28940,"Knoxville, TN Metro Area",Bus,2010,150,293,443,0,
2576,28940,"Knoxville, TN Metro Area",Bus,2011,504,79,583,0,
2577,28940,"Knoxville, TN Metro Area",Bus,2012,471,87,558,0,
2578,28940,"Knoxville, TN Metro Area",Bus,2013,380,123,503,0,
2579,28940,"Knoxville, TN Metro Area",Bus,2014,231,90,321,0,
2580,28940,"Knoxville, TN Metro Area",Bus,2015,253,42,295,0,
2581,28940,"Knoxville, TN Metro Area",Bus,2016,197,21,218,0,
2582,28940,"Knoxville, TN Metro Area",Bus,2017,280,24,304,0,
2583,28940,"Knoxville, TN Metro Area",Bus,2018,319,33,352,0,
2584,29020,"Kokomo, IN Metro Area",Bus,2002,0,0,0,1,Not reported
2585,29020,"Kokomo, IN Metro Area",Bus,2003,0,0,0,1,Not reported
2586,29020,"Kokomo, IN Metro Area",Bus,2004,0,0,0,1,Not reported
2587,29020,"Kokomo, IN Metro Area",Bus,2005,0,0,0,1,Not reported
2588,29020,"Kokomo, IN Metro Area",Bus,2006,0,0,0,1,Not reported
2589,29020,"Kokomo, IN Metro Area",Bus,2007,0,0,0,1,Not reported
2590,29020,"Kokomo, IN Metro Area",Bus,2008,0,0,0,1,Not reported
2591,29020,"Kokomo, IN Metro Area",Bus,2009,0,0,0,1,Not reported
2592,29020,"Kokomo, IN Metro Area",Bus,2010,2,2,4,0,
2593,29020,"Kokomo, IN Metro Area",Bus,2011,6,3,9,0,
2594,29020,"Kokomo, IN Metro Area",Bus,2012,6,4,10,0,
2595,29020,"Kokomo, IN Metro Area",Bus,2013,6,1,7,0,
2596,29020,"Kokomo, IN Metro Area",Bus,2014,2,5,7,0,
2597,29020,"Kokomo, IN Metro Area",Bus,2015,5,0,5,0,
2598,29020,"Kokomo, IN Metro Area",Bus,2016,1,0,1,0,
2599,29020,"Kokomo, IN Metro Area",Bus,2017,1,0,1,0,
2600,29020,"Kokomo, IN Metro Area",Bus,2018,8,3,11,0,
2601,29100,"La Crosse, WI-MN Metro Area",Bus,2002,15,29,44,0,
2602,29100,"La Crosse, WI-MN Metro Area",Bus,2003,13,31,44,0,
2603,29100,"La Crosse, WI-MN Metro Area",Bus,2004,10,25,35,0,
2604,29100,"La Crosse, WI-MN Metro Area",Bus,2005,15,24,39,0,
2605,29100,"La Crosse, WI-MN Metro Area",Bus,2006,13,27,40,0,
2606,29100,"La Crosse, WI-MN Metro Area",Bus,2007,13,30,43,0,
2607,29100,"La Crosse, WI-MN Metro Area",Bus,2008,10,31,41,0,
2608,29100,"La Crosse, WI-MN Metro Area",Bus,2009,47,27,74,0,
2609,29100,"La Crosse, WI-MN Metro Area",Bus,2010,51,35,86,0,
2610,29100,"La Crosse, WI-MN Metro Area",Bus,2011,56,41,97,0,
2611,29100,"La Crosse, WI-MN Metro Area",Bus,2012,62,42,104,0,
2612,29100,"La Crosse, WI-MN Metro Area",Bus,2013,58,73,131,0,
2613,29100,"La Crosse, WI-MN Metro Area",Bus,2014,107,114,221,0,
2614,29100,"La Crosse, WI-MN Metro Area",Bus,2015,54,136,190,0,
2615,29100,"La Crosse, WI-MN Metro Area",Bus,2016,89,128,217,0,
2616,29100,"La Crosse, WI-MN Metro Area",Bus,2017,103,219,322,0,
2617,29100,"La Crosse, WI-MN Metro Area",Bus,2018,122,180,302,0,
2618,29140,"Lafayette, IN Metro Area",Bus,2002,24,53,77,0,
2619,29140,"Lafayette, IN Metro Area",Bus,2003,10,64,74,0,
2620,29140,"Lafayette, IN Metro Area",Bus,2004,9,50,59,0,
2621,29140,"Lafayette, IN Metro Area",Bus,2005,9,99,108,0,
2622,29140,"Lafayette, IN Metro Area",Bus,2006,15,98,113,0,
2623,29140,"Lafayette, IN Metro Area",Bus,2007,8,71,79,0,
2624,29140,"Lafayette, IN Metro Area",Bus,2008,69,7,76,0,
2625,29140,"Lafayette, IN Metro Area",Bus,2009,58,2,60,0,
2626,29140,"Lafayette, IN Metro Area",Bus,2010,23,1,24,0,
2627,29140,"Lafayette, IN Metro Area",Bus,2011,20,1,21,0,
2628,29140,"Lafayette, IN Metro Area",Bus,2012,7,0,7,0,
2629,29140,"Lafayette, IN Metro Area",Bus,2013,21,3,24,0,
2630,29140,"Lafayette, IN Metro Area",Bus,2014,17,0,17,0,
2631,29140,"Lafayette, IN Metro Area",Bus,2015,4,11,15,0,
2632,29140,"Lafayette, IN Metro Area",Bus,2016,23,12,35,0,
2633,29140,"Lafayette, IN Metro Area",Bus,2017,17,16,33,0,
2634,29140,"Lafayette, IN Metro Area",Bus,2018,17,2,19,0,
2635,29180,"Lafayette, LA Metro Area",Bus,2002,23,965,988,0,
2636,29180,"Lafayette, LA Metro Area",Bus,2003,22,319,341,0,
2637,29180,"Lafayette, LA Metro Area",Bus,2004,12,396,408,0,
2638,29180,"Lafayette, LA Metro Area",Bus,2005,19,432,451,0,
2639,29180,"Lafayette, LA Metro Area",Bus,2006,23,453,476,0,
2640,29180,"Lafayette, LA Metro Area",Bus,2007,12,439,451,0,
2641,29180,"Lafayette, LA Metro Area",Bus,2008,90,635,725,0,
2642,29180,"Lafayette, LA Metro Area",Bus,2009,47,740,787,0,
2643,29180,"Lafayette, LA Metro Area",Bus,2010,49,767,816,0,
2644,29180,"Lafayette, LA Metro Area",Bus,2011,56,807,863,0,
2645,29180,"Lafayette, LA Metro Area",Bus,2012,45,439,484,0,
2646,29180,"Lafayette, LA Metro Area",Bus,2013,41,239,280,0,
2647,29180,"Lafayette, LA Metro Area",Bus,2014,38,467,505,0,
2648,29180,"Lafayette, LA Metro Area",Bus,2015,31,554,585,0,
2649,29180,"Lafayette, LA Metro Area",Bus,2016,30,348,378,0,
2650,29180,"Lafayette, LA Metro Area",Bus,2017,36,357,393,0,
2651,29180,"Lafayette, LA Metro Area",Bus,2018,44,369,413,0,
2669,29460,"Lakeland-Winter Haven, FL Metro Area",Bus,2002,84,116,200,0,
2670,29460,"Lakeland-Winter Haven, FL Metro Area",Bus,2003,5,218,223,0,
2671,29460,"Lakeland-Winter Haven, FL Metro Area",Bus,2004,41,130,171,0,
2672,29460,"Lakeland-Winter Haven, FL Metro Area",Bus,2005,250,223,473,0,
2673,29460,"Lakeland-Winter Haven, FL Metro Area",Bus,2006,231,199,430,0,
2674,29460,"Lakeland-Winter Haven, FL Metro Area",Bus,2007,151,292,443,0,
2675,29460,"Lakeland-Winter Haven, FL Metro Area",Bus,2008,122,131,253,0,
2676,29460,"Lakeland-Winter Haven, FL Metro Area",Bus,2009,132,32,164,0,
2677,29460,"Lakeland-Winter Haven, FL Metro Area",Bus,2010,119,95,214,0,
2678,29460,"Lakeland-Winter Haven, FL Metro Area",Bus,2011,124,218,342,0,
2679,29460,"Lakeland-Winter Haven, FL Metro Area",Bus,2012,431,827,1258,0,
2680,29460,"Lakeland-Winter Haven, FL Metro Area",Bus,2013,329,423,752,0,
2681,29460,"Lakeland-Winter Haven, FL Metro Area",Bus,2014,329,186,515,0,
2682,29460,"Lakeland-Winter Haven, FL Metro Area",Bus,2015,272,120,392,0,
2683,29460,"Lakeland-Winter Haven, FL Metro Area",Bus,2016,56,318,374,0,
2684,29460,"Lakeland-Winter Haven, FL Metro Area",Bus,2017,262,13,275,0,
2685,29460,"Lakeland-Winter Haven, FL Metro Area",Bus,2018,215,1,216,0,
2703,29620,"Lansing-East Lansing, MI Metro Area",Bus,2002,189,53,242,0,
2704,29620,"Lansing-East Lansing, MI Metro Area",Bus,2003,177,102,279,0,
2705,29620,"Lansing-East Lansing, MI Metro Area",Bus,2004,216,130,346,0,
2706,29620,"Lansing-East Lansing, MI Metro Area",Bus,2005,296,166,462,0,
2707,29620,"Lansing-East Lansing, MI Metro Area",Bus,2006,204,152,356,0,
2708,29620,"Lansing-East Lansing, MI Metro Area",Bus,2007,239,149,388,0,
2709,29620,"Lansing-East Lansing, MI Metro Area",Bus,2008,222,213,435,0,
2710,29620,"Lansing-East Lansing, MI Metro Area",Bus,2009,245,223,468,0,
2711,29620,"Lansing-East Lansing, MI Metro Area",Bus,2010,248,175,423,0,
2712,29620,"Lansing-East Lansing, MI Metro Area",Bus,2011,267,169,436,0,
2713,29620,"Lansing-East Lansing, MI Metro Area",Bus,2012,361,176,537,0,
2714,29620,"Lansing-East Lansing, MI Metro Area",Bus,2013,233,99,332,0,
2715,29620,"Lansing-East Lansing, MI Metro Area",Bus,2014,456,147,603,0,
2716,29620,"Lansing-East Lansing, MI Metro Area",Bus,2015,368,89,457,0,
2717,29620,"Lansing-East Lansing, MI Metro Area",Bus,2016,491,71,562,0,
2718,29620,"Lansing-East Lansing, MI Metro Area",Bus,2017,403,35,438,0,
2719,29620,"Lansing-East Lansing, MI Metro Area",Bus,2018,304,95,399,0,
2720,29700,"Laredo, TX Metro Area",Bus,2002,122,495,617,0,
2721,29700,"Laredo, TX Metro Area",Bus,2003,125,485,610,0,
2722,29700,"Laredo, TX Metro Area",Bus,2004,1544,1082,2626,0,
2723,29700,"Laredo, TX Metro Area",Bus,2005,2294,2455,4749,0,
2724,29700,"Laredo, TX Metro Area",Bus,2006,364,0,364,1,Other not reported
2725,29700,"Laredo, TX Metro Area",Bus,2007,390,0,390,1,Other not reported
2726,29700,"Laredo, TX Metro Area",Bus,2008,385,0,385,1,Other not reported
2727,29700,"Laredo, TX Metro Area",Bus,2009,342,0,342,1,Other not reported
2728,29700,"Laredo, TX Metro Area",Bus,2010,330,0,330,1,Other not reported
2729,29700,"Laredo, TX Metro Area",Bus,2011,1484,390,1874,0,
2730,29700,"Laredo, TX Metro Area",Bus,2012,254,126,380,0,
2731,29700,"Laredo, TX Metro Area",Bus,2013,97,137,234,0,
2732,29700,"Laredo, TX Metro Area",Bus,2014,84,117,201,0,
2733,29700,"Laredo, TX Metro Area",Bus,2015,78,114,192,0,
2734,29700,"Laredo, TX Metro Area",Bus,2016,60,78,138,0,
2735,29700,"Laredo, TX Metro Area",Bus,2017,46,58,104,0,
2736,29700,"Laredo, TX Metro Area",Bus,2018,30,39,69,0,
2737,29820,"Las Vegas-Paradise, NV Metro Area",Bus,2002,0,0,0,1,Not reported
2738,29820,"Las Vegas-Paradise, NV Metro Area",Bus,2003,0,0,0,1,Not reported
2739,29820,"Las Vegas-Paradise, NV Metro Area",Bus,2004,0,0,0,1,Not reported
2740,29820,"Las Vegas-Paradise, NV Metro Area",Bus,2005,0,0,0,1,Not reported
2741,29820,"Las Vegas-Paradise, NV Metro Area",Bus,2006,0,0,0,1,Not reported
2742,29820,"Las Vegas-Paradise, NV Metro Area",Bus,2007,0,0,0,1,Not reported
2743,29820,"Las Vegas-Paradise, NV Metro Area",Bus,2008,0,0,0,1,Not reported
2744,29820,"Las Vegas-Paradise, NV Metro Area",Bus,2009,1085,33,1118,0,
2745,29820,"Las Vegas-Paradise, NV Metro Area",Bus,2010,1022,37,1059,0,
2746,29820,"Las Vegas-Paradise, NV Metro Area",Bus,2011,1100,13,1113,0,
2747,29820,"Las Vegas-Paradise, NV Metro Area",Bus,2012,1170,41,1211,0,
2748,29820,"Las Vegas-Paradise, NV Metro Area",Bus,2013,1642,92,1734,0,
2749,29820,"Las Vegas-Paradise, NV Metro Area",Bus,2014,1461,13,1474,0,
2750,29820,"Las Vegas-Paradise, NV Metro Area",Bus,2015,826,840,1666,0,
2751,29820,"Las Vegas-Paradise, NV Metro Area",Bus,2016,1197,501,1698,0,
2752,29820,"Las Vegas-Paradise, NV Metro Area",Bus,2017,811,409,1220,0,
2753,29820,"Las Vegas-Paradise, NV Metro Area",Bus,2018,821,319,1140,0,
2754,30140,"Lebanon, PA Metro Area",Bus,2002,0,0,0,1,Not reported
2755,30140,"Lebanon, PA Metro Area",Bus,2003,0,0,0,1,Not reported
2756,30140,"Lebanon, PA Metro Area",Bus,2004,0,0,0,1,Not reported
2757,30140,"Lebanon, PA Metro Area",Bus,2005,0,0,0,1,Not reported
2758,30140,"Lebanon, PA Metro Area",Bus,2006,17,26,43,0,
2759,30140,"Lebanon, PA Metro Area",Bus,2007,11,24,35,0,
2760,30140,"Lebanon, PA Metro Area",Bus,2008,13,27,40,0,
2761,30140,"Lebanon, PA Metro Area",Bus,2009,10,23,33,0,
2762,30140,"Lebanon, PA Metro Area",Bus,2010,12,16,28,0,
2763,30140,"Lebanon, PA Metro Area",Bus,2011,13,17,30,0,
2764,30140,"Lebanon, PA Metro Area",Bus,2012,11,16,27,0,
2765,30140,"Lebanon, PA Metro Area",Bus,2013,14,8,22,0,
2766,30140,"Lebanon, PA Metro Area",Bus,2014,10,2,12,0,
2767,30140,"Lebanon, PA Metro Area",Bus,2015,7,3,10,0,
2768,30140,"Lebanon, PA Metro Area",Bus,2016,3,6,9,0,
2769,30140,"Lebanon, PA Metro Area",Bus,2017,9,10,19,0,
2770,30140,"Lebanon, PA Metro Area",Bus,2018,10,9,19,0,
2805,30460,"Lexington-Fayette, KY Metro Area",Bus,2002,607,327,934,0,
2806,30460,"Lexington-Fayette, KY Metro Area",Bus,2003,313,679,992,0,
2807,30460,"Lexington-Fayette, KY Metro Area",Bus,2004,212,809,1021,0,
2808,30460,"Lexington-Fayette, KY Metro Area",Bus,2005,230,404,634,0,
2809,30460,"Lexington-Fayette, KY Metro Area",Bus,2006,227,422,649,0,
2810,30460,"Lexington-Fayette, KY Metro Area",Bus,2007,1045,235,1280,0,
2811,30460,"Lexington-Fayette, KY Metro Area",Bus,2008,623,371,994,0,
2812,30460,"Lexington-Fayette, KY Metro Area",Bus,2009,548,556,1104,0,
2813,30460,"Lexington-Fayette, KY Metro Area",Bus,2010,685,357,1042,0,
2814,30460,"Lexington-Fayette, KY Metro Area",Bus,2011,428,707,1135,0,
2815,30460,"Lexington-Fayette, KY Metro Area",Bus,2012,446,275,721,0,
2816,30460,"Lexington-Fayette, KY Metro Area",Bus,2013,524,186,710,0,
2817,30460,"Lexington-Fayette, KY Metro Area",Bus,2014,400,135,535,0,
2818,30460,"Lexington-Fayette, KY Metro Area",Bus,2015,479,148,627,0,
2819,30460,"Lexington-Fayette, KY Metro Area",Bus,2016,345,187,532,0,
2820,30460,"Lexington-Fayette, KY Metro Area",Bus,2017,267,80,347,0,
2821,30460,"Lexington-Fayette, KY Metro Area",Bus,2018,319,64,383,0,
2822,30700,"Lincoln, NE Metro Area",Bus,2002,199,275,474,0,
2823,30700,"Lincoln, NE Metro Area",Bus,2003,146,248,394,0,
2824,30700,"Lincoln, NE Metro Area",Bus,2004,158,167,325,0,
2825,30700,"Lincoln, NE Metro Area",Bus,2005,118,156,274,0,
2826,30700,"Lincoln, NE Metro Area",Bus,2006,182,168,350,0,
2827,30700,"Lincoln, NE Metro Area",Bus,2007,161,166,327,0,
2828,30700,"Lincoln, NE Metro Area",Bus,2008,148,250,398,0,
2829,30700,"Lincoln, NE Metro Area",Bus,2009,106,139,245,0,
2830,30700,"Lincoln, NE Metro Area",Bus,2010,144,167,311,0,
2831,30700,"Lincoln, NE Metro Area",Bus,2011,129,158,287,0,
2832,30700,"Lincoln, NE Metro Area",Bus,2012,143,131,274,0,
2833,30700,"Lincoln, NE Metro Area",Bus,2013,139,104,243,0,
2834,30700,"Lincoln, NE Metro Area",Bus,2014,174,147,321,0,
2835,30700,"Lincoln, NE Metro Area",Bus,2015,170,177,347,0,
2836,30700,"Lincoln, NE Metro Area",Bus,2016,193,170,363,0,
2837,30700,"Lincoln, NE Metro Area",Bus,2017,308,169,477,0,
2838,30700,"Lincoln, NE Metro Area",Bus,2018,382,124,506,0,
2839,30780,"Little Rock-North Little Rock-Conway, AR Metro Area",Bus,2002,214,107,321,0,
2840,30780,"Little Rock-North Little Rock-Conway, AR Metro Area",Bus,2003,232,48,280,0,
2841,30780,"Little Rock-North Little Rock-Conway, AR Metro Area",Bus,2004,241,43,284,0,
2842,30780,"Little Rock-North Little Rock-Conway, AR Metro Area",Bus,2005,243,45,288,0,
2843,30780,"Little Rock-North Little Rock-Conway, AR Metro Area",Bus,2006,234,55,289,0,
2844,30780,"Little Rock-North Little Rock-Conway, AR Metro Area",Bus,2007,160,128,288,0,
2845,30780,"Little Rock-North Little Rock-Conway, AR Metro Area",Bus,2008,192,105,297,0,
2846,30780,"Little Rock-North Little Rock-Conway, AR Metro Area",Bus,2009,120,110,230,0,
2847,30780,"Little Rock-North Little Rock-Conway, AR Metro Area",Bus,2010,89,108,197,0,
2848,30780,"Little Rock-North Little Rock-Conway, AR Metro Area",Bus,2011,138,170,308,0,
2849,30780,"Little Rock-North Little Rock-Conway, AR Metro Area",Bus,2012,139,149,288,0,
2850,30780,"Little Rock-North Little Rock-Conway, AR Metro Area",Bus,2013,134,144,278,0,
2851,30780,"Little Rock-North Little Rock-Conway, AR Metro Area",Bus,2014,167,187,354,0,
2852,30780,"Little Rock-North Little Rock-Conway, AR Metro Area",Bus,2015,126,209,335,0,
2853,30780,"Little Rock-North Little Rock-Conway, AR Metro Area",Bus,2016,95,179,274,0,
2854,30780,"Little Rock-North Little Rock-Conway, AR Metro Area",Bus,2017,99,161,260,0,
2855,30780,"Little Rock-North Little Rock-Conway, AR Metro Area",Bus,2018,125,409,534,0,
2856,30780,"Little Rock-North Little Rock-Conway, AR Metro Area",Rail,2002,0,0,0,1,
2857,30780,"Little Rock-North Little Rock-Conway, AR Metro Area",Rail,2003,0,0,0,1,
2858,30780,"Little Rock-North Little Rock-Conway, AR Metro Area",Rail,2004,0,3,3,0,
2859,30780,"Little Rock-North Little Rock-Conway, AR Metro Area",Rail,2005,6,3,9,0,
2860,30780,"Little Rock-North Little Rock-Conway, AR Metro Area",Rail,2006,8,12,20,0,
2861,30780,"Little Rock-North Little Rock-Conway, AR Metro Area",Rail,2007,9,13,22,0,
2862,30780,"Little Rock-North Little Rock-Conway, AR Metro Area",Rail,2008,4,3,7,0,
2863,30780,"Little Rock-North Little Rock-Conway, AR Metro Area",Rail,2009,3,6,9,0,
2864,30780,"Little Rock-North Little Rock-Conway, AR Metro Area",Rail,2010,6,4,10,0,
2865,30780,"Little Rock-North Little Rock-Conway, AR Metro Area",Rail,2011,4,6,10,0,
2866,30780,"Little Rock-North Little Rock-Conway, AR Metro Area",Rail,2012,2,7,9,0,
2867,30780,"Little Rock-North Little Rock-Conway, AR Metro Area",Rail,2013,2,10,12,0,
2868,30780,"Little Rock-North Little Rock-Conway, AR Metro Area",Rail,2014,3,12,15,0,
2869,30780,"Little Rock-North Little Rock-Conway, AR Metro Area",Rail,2015,5,16,21,0,
2870,30780,"Little Rock-North Little Rock-Conway, AR Metro Area",Rail,2016,5,12,17,0,
2871,30780,"Little Rock-North Little Rock-Conway, AR Metro Area",Rail,2017,8,19,27,0,
2872,30780,"Little Rock-North Little Rock-Conway, AR Metro Area",Rail,2018,6,14,20,0,
2873,30860,"Logan, UT-ID Metro Area",Bus,2002,0,0,0,1,
2874,30860,"Logan, UT-ID Metro Area",Bus,2003,0,0,0,1,
2875,30860,"Logan, UT-ID Metro Area",Bus,2004,0,0,0,1,
2876,30860,"Logan, UT-ID Metro Area",Bus,2005,0,0,0,1,
2877,30860,"Logan, UT-ID Metro Area",Bus,2006,0,0,0,1,
2878,30860,"Logan, UT-ID Metro Area",Bus,2007,0,0,0,1,
2879,30860,"Logan, UT-ID Metro Area",Bus,2008,0,0,0,1,
2880,30860,"Logan, UT-ID Metro Area",Bus,2009,33,9,42,0,
2881,30860,"Logan, UT-ID Metro Area",Bus,2010,46,35,81,0,
2882,30860,"Logan, UT-ID Metro Area",Bus,2011,68,59,127,0,
2883,30860,"Logan, UT-ID Metro Area",Bus,2012,54,70,124,0,
2884,30860,"Logan, UT-ID Metro Area",Bus,2013,40,61,101,0,
2885,30860,"Logan, UT-ID Metro Area",Bus,2014,38,82,120,0,
2886,30860,"Logan, UT-ID Metro Area",Bus,2015,64,58,122,0,
2887,30860,"Logan, UT-ID Metro Area",Bus,2016,62,106,168,0,
2888,30860,"Logan, UT-ID Metro Area",Bus,2017,46,115,161,0,
2889,30860,"Logan, UT-ID Metro Area",Bus,2018,57,108,165,0,
2890,31020,"Longview, WA Metro Area",Bus,2002,9,20,29,0,
2891,31020,"Longview, WA Metro Area",Bus,2003,12,30,42,0,
2892,31020,"Longview, WA Metro Area",Bus,2004,17,6,23,0,
2893,31020,"Longview, WA Metro Area",Bus,2005,8,12,20,0,
2894,31020,"Longview, WA Metro Area",Bus,2006,15,4,19,0,
2895,31020,"Longview, WA Metro Area",Bus,2007,13,3,16,0,
2896,31020,"Longview, WA Metro Area",Bus,2008,7,9,16,0,
2897,31020,"Longview, WA Metro Area",Bus,2009,17,23,40,0,
2898,31020,"Longview, WA Metro Area",Bus,2010,27,19,46,0,
2899,31020,"Longview, WA Metro Area",Bus,2011,5,29,34,0,
2900,31020,"Longview, WA Metro Area",Bus,2012,23,21,44,0,
2901,31020,"Longview, WA Metro Area",Bus,2013,18,16,34,0,
2902,31020,"Longview, WA Metro Area",Bus,2014,22,17,39,0,
2903,31020,"Longview, WA Metro Area",Bus,2015,28,4,32,0,
2904,31020,"Longview, WA Metro Area",Bus,2016,56,6,62,0,
2905,31020,"Longview, WA Metro Area",Bus,2017,42,10,52,0,
2906,31020,"Longview, WA Metro Area",Bus,2018,27,12,39,0,
2686,31100,"Los Angeles-Long Beach-Santa Ana, CA Metro Area",Bus,2002,0,0,0,0,
2907,31100,"Los Angeles-Long Beach-Santa Ana, CA Metro Area",Bus,2002,25795,4019,29814,0,
3128,31100,"Los Angeles-Long Beach-Santa Ana, CA Metro Area",Bus,2002,14,8,22,0,
4505,31100,"Los Angeles-Long Beach-Santa Ana, CA Metro Area",Bus,2002,0,0,0,0,
2687,31100,"Los Angeles-Long Beach-Santa Ana, CA Metro Area",Bus,2003,0,0,0,0,
2908,31100,"Los Angeles-Long Beach-Santa Ana, CA Metro Area",Bus,2003,20925,4256,25181,0,
3129,31100,"Los Angeles-Long Beach-Santa Ana, CA Metro Area",Bus,2003,5,6,11,0,
4506,31100,"Los Angeles-Long Beach-Santa Ana, CA Metro Area",Bus,2003,0,0,0,0,
2688,31100,"Los Angeles-Long Beach-Santa Ana, CA Metro Area",Bus,2004,0,0,0,0,
2909,31100,"Los Angeles-Long Beach-Santa Ana, CA Metro Area",Bus,2004,18627,5880,24507,0,
3130,31100,"Los Angeles-Long Beach-Santa Ana, CA Metro Area",Bus,2004,6,7,13,0,
4507,31100,"Los Angeles-Long Beach-Santa Ana, CA Metro Area",Bus,2004,0,0,0,0,
2689,31100,"Los Angeles-Long Beach-Santa Ana, CA Metro Area",Bus,2005,0,0,0,0,
2910,31100,"Los Angeles-Long Beach-Santa Ana, CA Metro Area",Bus,2005,27776,5887,33663,0,
3131,31100,"Los Angeles-Long Beach-Santa Ana, CA Metro Area",Bus,2005,7,8,15,0,
4508,31100,"Los Angeles-Long Beach-Santa Ana, CA Metro Area",Bus,2005,0,0,0,0,
2690,31100,"Los Angeles-Long Beach-Santa Ana, CA Metro Area",Bus,2006,0,0,0,0,
2911,31100,"Los Angeles-Long Beach-Santa Ana, CA Metro Area",Bus,2006,18127,22069,40196,0,
3132,31100,"Los Angeles-Long Beach-Santa Ana, CA Metro Area",Bus,2006,13,18,31,0,
4509,31100,"Los Angeles-Long Beach-Santa Ana, CA Metro Area",Bus,2006,0,0,0,0,
2691,31100,"Los Angeles-Long Beach-Santa Ana, CA Metro Area",Bus,2007,0,0,0,0,
2912,31100,"Los Angeles-Long Beach-Santa Ana, CA Metro Area",Bus,2007,18113,22158,40271,0,
3133,31100,"Los Angeles-Long Beach-Santa Ana, CA Metro Area",Bus,2007,13,18,31,0,
4510,31100,"Los Angeles-Long Beach-Santa Ana, CA Metro Area",Bus,2007,0,0,0,0,
2692,31100,"Los Angeles-Long Beach-Santa Ana, CA Metro Area",Bus,2008,421,618,1039,0,
2913,31100,"Los Angeles-Long Beach-Santa Ana, CA Metro Area",Bus,2008,20495,21426,41921,0,
3134,31100,"Los Angeles-Long Beach-Santa Ana, CA Metro Area",Bus,2008,15,19,34,0,
4511,31100,"Los Angeles-Long Beach-Santa Ana, CA Metro Area",Bus,2008,0,0,0,0,
2693,31100,"Los Angeles-Long Beach-Santa Ana, CA Metro Area",Bus,2009,376,552,928,0,
2914,31100,"Los Angeles-Long Beach-Santa Ana, CA Metro Area",Bus,2009,20565,27666,48231,0,
3135,31100,"Los Angeles-Long Beach-Santa Ana, CA Metro Area",Bus,2009,15,19,34,0,
4512,31100,"Los Angeles-Long Beach-Santa Ana, CA Metro Area",Bus,2009,87,88,175,0,
2694,31100,"Los Angeles-Long Beach-Santa Ana, CA Metro Area",Bus,2010,493,589,1082,0,
2915,31100,"Los Angeles-Long Beach-Santa Ana, CA Metro Area",Bus,2010,18613,24433,43046,0,
3136,31100,"Los Angeles-Long Beach-Santa Ana, CA Metro Area",Bus,2010,16,11,27,0,
4513,31100,"Los Angeles-Long Beach-Santa Ana, CA Metro Area",Bus,2010,218,10,228,0,
2695,31100,"Los Angeles-Long Beach-Santa Ana, CA Metro Area",Bus,2011,163,215,378,0,
2916,31100,"Los Angeles-Long Beach-Santa Ana, CA Metro Area",Bus,2011,16346,22387,38733,0,
3137,31100,"Los Angeles-Long Beach-Santa Ana, CA Metro Area",Bus,2011,26,16,42,0,
4514,31100,"Los Angeles-Long Beach-Santa Ana, CA Metro Area",Bus,2011,179,60,239,0,
2696,31100,"Los Angeles-Long Beach-Santa Ana, CA Metro Area",Bus,2012,307,458,765,0,
2917,31100,"Los Angeles-Long Beach-Santa Ana, CA Metro Area",Bus,2012,14620,20968,35588,0,
3138,31100,"Los Angeles-Long Beach-Santa Ana, CA Metro Area",Bus,2012,31,13,44,0,
4515,31100,"Los Angeles-Long Beach-Santa Ana, CA Metro Area",Bus,2012,168,43,211,0,
2697,31100,"Los Angeles-Long Beach-Santa Ana, CA Metro Area",Bus,2013,105,284,389,0,
2918,31100,"Los Angeles-Long Beach-Santa Ana, CA Metro Area",Bus,2013,14428,20489,34917,0,
3139,31100,"Los Angeles-Long Beach-Santa Ana, CA Metro Area",Bus,2013,25,28,53,0,
4516,31100,"Los Angeles-Long Beach-Santa Ana, CA Metro Area",Bus,2013,94,113,207,0,
2698,31100,"Los Angeles-Long Beach-Santa Ana, CA Metro Area",Bus,2014,108,273,381,0,
2919,31100,"Los Angeles-Long Beach-Santa Ana, CA Metro Area",Bus,2014,14464,18721,33185,0,
3140,31100,"Los Angeles-Long Beach-Santa Ana, CA Metro Area",Bus,2014,25,28,53,0,
4517,31100,"Los Angeles-Long Beach-Santa Ana, CA Metro Area",Bus,2014,36,85,121,0,
2699,31100,"Los Angeles-Long Beach-Santa Ana, CA Metro Area",Bus,2015,73,46,119,0,
2920,31100,"Los Angeles-Long Beach-Santa Ana, CA Metro Area",Bus,2015,13921,16393,30314,0,
3141,31100,"Los Angeles-Long Beach-Santa Ana, CA Metro Area",Bus,2015,37,57,94,0,
4518,31100,"Los Angeles-Long Beach-Santa Ana, CA Metro Area",Bus,2015,86,53,139,0,
2700,31100,"Los Angeles-Long Beach-Santa Ana, CA Metro Area",Bus,2016,159,90,249,0,
2921,31100,"Los Angeles-Long Beach-Santa Ana, CA Metro Area",Bus,2016,12630,16373,29003,0,
3142,31100,"Los Angeles-Long Beach-Santa Ana, CA Metro Area",Bus,2016,71,91,162,0,
4519,31100,"Los Angeles-Long Beach-Santa Ana, CA Metro Area",Bus,2016,157,246,403,0,
2701,31100,"Los Angeles-Long Beach-Santa Ana, CA Metro Area",Bus,2017,140,100,240,0,
2922,31100,"Los Angeles-Long Beach-Santa Ana, CA Metro Area",Bus,2017,11550,15047,26597,0,
3143,31100,"Los Angeles-Long Beach-Santa Ana, CA Metro Area",Bus,2017,90,87,177,0,
4520,31100,"Los Angeles-Long Beach-Santa Ana, CA Metro Area",Bus,2017,127,288,415,0,
2702,31100,"Los Angeles-Long Beach-Santa Ana, CA Metro Area",Bus,2018,167,167,334,0,
2923,31100,"Los Angeles-Long Beach-Santa Ana, CA Metro Area",Bus,2018,12777,15800,28577,0,
3144,31100,"Los Angeles-Long Beach-Santa Ana, CA Metro Area",Bus,2018,93,106,199,0,
4521,31100,"Los Angeles-Long Beach-Santa Ana, CA Metro Area",Bus,2018,132,332,464,0,
2924,31100,"Los Angeles-Long Beach-Santa Ana, CA Metro Area",Rail,2002,1941,1925,3866,0,
2925,31100,"Los Angeles-Long Beach-Santa Ana, CA Metro Area",Rail,2003,1893,1759,3652,0,
2926,31100,"Los Angeles-Long Beach-Santa Ana, CA Metro Area",Rail,2004,867,948,1815,0,
2927,31100,"Los Angeles-Long Beach-Santa Ana, CA Metro Area",Rail,2005,1084,3318,4402,0,
2928,31100,"Los Angeles-Long Beach-Santa Ana, CA Metro Area",Rail,2006,667,3586,4253,0,
2929,31100,"Los Angeles-Long Beach-Santa Ana, CA Metro Area",Rail,2007,678,4135,4813,0,
2930,31100,"Los Angeles-Long Beach-Santa Ana, CA Metro Area",Rail,2008,403,95,498,0,
2931,31100,"Los Angeles-Long Beach-Santa Ana, CA Metro Area",Rail,2009,643,134,777,0,
2932,31100,"Los Angeles-Long Beach-Santa Ana, CA Metro Area",Rail,2010,724,168,892,0,
2933,31100,"Los Angeles-Long Beach-Santa Ana, CA Metro Area",Rail,2011,683,180,863,0,
2934,31100,"Los Angeles-Long Beach-Santa Ana, CA Metro Area",Rail,2012,742,201,943,0,
2935,31100,"Los Angeles-Long Beach-Santa Ana, CA Metro Area",Rail,2013,797,133,930,0,
2936,31100,"Los Angeles-Long Beach-Santa Ana, CA Metro Area",Rail,2014,736,165,901,0,
2937,31100,"Los Angeles-Long Beach-Santa Ana, CA Metro Area",Rail,2015,623,128,751,0,
2938,31100,"Los Angeles-Long Beach-Santa Ana, CA Metro Area",Rail,2016,658,133,791,0,
2939,31100,"Los Angeles-Long Beach-Santa Ana, CA Metro Area",Rail,2017,786,79,865,0,
2940,31100,"Los Angeles-Long Beach-Santa Ana, CA Metro Area",Rail,2018,802,89,891,0,
2941,31140,"Louisville/Jefferson County, KY-IN Metro Area",Bus,2002,1355,1324,2679,0,
2942,31140,"Louisville/Jefferson County, KY-IN Metro Area",Bus,2003,1565,1455,3020,0,
2943,31140,"Louisville/Jefferson County, KY-IN Metro Area",Bus,2004,1349,1442,2791,0,
2944,31140,"Louisville/Jefferson County, KY-IN Metro Area",Bus,2005,1463,1584,3047,0,
2945,31140,"Louisville/Jefferson County, KY-IN Metro Area",Bus,2006,1993,459,2452,0,
2946,31140,"Louisville/Jefferson County, KY-IN Metro Area",Bus,2007,1505,1030,2535,0,
2947,31140,"Louisville/Jefferson County, KY-IN Metro Area",Bus,2008,1562,1118,2680,0,
2948,31140,"Louisville/Jefferson County, KY-IN Metro Area",Bus,2009,1451,957,2408,0,
2949,31140,"Louisville/Jefferson County, KY-IN Metro Area",Bus,2010,1298,981,2279,0,
2950,31140,"Louisville/Jefferson County, KY-IN Metro Area",Bus,2011,1192,1610,2802,0,
2951,31140,"Louisville/Jefferson County, KY-IN Metro Area",Bus,2012,1235,1944,3179,0,
2952,31140,"Louisville/Jefferson County, KY-IN Metro Area",Bus,2013,1280,2185,3465,0,
2953,31140,"Louisville/Jefferson County, KY-IN Metro Area",Bus,2014,1130,2395,3525,0,
2954,31140,"Louisville/Jefferson County, KY-IN Metro Area",Bus,2015,1002,2270,3272,0,
2955,31140,"Louisville/Jefferson County, KY-IN Metro Area",Bus,2016,1267,2415,3682,0,
2956,31140,"Louisville/Jefferson County, KY-IN Metro Area",Bus,2017,1182,2333,3515,0,
2957,31140,"Louisville/Jefferson County, KY-IN Metro Area",Bus,2018,1329,2415,3744,0,
2958,31180,"Lubbock, TX Metro Area",Bus,2002,96,0,96,0,
2959,31180,"Lubbock, TX Metro Area",Bus,2003,19,11,30,0,
2960,31180,"Lubbock, TX Metro Area",Bus,2004,69,62,131,0,
2961,31180,"Lubbock, TX Metro Area",Bus,2005,52,62,114,0,
2962,31180,"Lubbock, TX Metro Area",Bus,2006,71,73,144,0,
2963,31180,"Lubbock, TX Metro Area",Bus,2007,45,50,95,0,
2964,31180,"Lubbock, TX Metro Area",Bus,2008,67,181,248,0,
2965,31180,"Lubbock, TX Metro Area",Bus,2009,93,29,122,0,
2966,31180,"Lubbock, TX Metro Area",Bus,2010,167,63,230,0,
2967,31180,"Lubbock, TX Metro Area",Bus,2011,234,84,318,0,
2968,31180,"Lubbock, TX Metro Area",Bus,2012,220,128,348,0,
2969,31180,"Lubbock, TX Metro Area",Bus,2013,236,132,368,0,
2970,31180,"Lubbock, TX Metro Area",Bus,2014,283,159,442,0,
2971,31180,"Lubbock, TX Metro Area",Bus,2015,198,114,312,0,
2972,31180,"Lubbock, TX Metro Area",Bus,2016,238,136,374,0,
2973,31180,"Lubbock, TX Metro Area",Bus,2017,190,71,261,0,
2974,31180,"Lubbock, TX Metro Area",Bus,2018,51,150,201,0,
2975,31340,"Lynchburg, VA Metro Area",Bus,2002,201,159,360,0,
2976,31340,"Lynchburg, VA Metro Area",Bus,2003,297,235,532,0,
2977,31340,"Lynchburg, VA Metro Area",Bus,2004,292,231,523,0,
2978,31340,"Lynchburg, VA Metro Area",Bus,2005,319,205,524,0,
2979,31340,"Lynchburg, VA Metro Area",Bus,2006,424,238,662,0,
2980,31340,"Lynchburg, VA Metro Area",Bus,2007,983,810,1793,0,
2981,31340,"Lynchburg, VA Metro Area",Bus,2008,171,710,881,0,
2982,31340,"Lynchburg, VA Metro Area",Bus,2009,162,196,358,0,
2983,31340,"Lynchburg, VA Metro Area",Bus,2010,130,202,332,0,
2984,31340,"Lynchburg, VA Metro Area",Bus,2011,98,154,252,0,
2985,31340,"Lynchburg, VA Metro Area",Bus,2012,1,11,12,1,
2986,31340,"Lynchburg, VA Metro Area",Bus,2013,2,10,12,1,
2987,31340,"Lynchburg, VA Metro Area",Bus,2014,5,45,50,1,
2988,31340,"Lynchburg, VA Metro Area",Bus,2015,6,42,48,1,
2989,31340,"Lynchburg, VA Metro Area",Bus,2016,12,31,43,1,
2990,31340,"Lynchburg, VA Metro Area",Bus,2017,23,7,30,1,
2991,31340,"Lynchburg, VA Metro Area",Bus,2018,33,4,37,1,
2992,31540,"Madison, WI Metro Area",Bus,2002,405,235,640,0,
2993,31540,"Madison, WI Metro Area",Bus,2003,354,234,588,0,
2994,31540,"Madison, WI Metro Area",Bus,2004,489,202,691,0,
2995,31540,"Madison, WI Metro Area",Bus,2005,388,371,759,0,
2996,31540,"Madison, WI Metro Area",Bus,2006,324,439,763,0,
2997,31540,"Madison, WI Metro Area",Bus,2007,404,508,912,0,
2998,31540,"Madison, WI Metro Area",Bus,2008,437,445,882,0,
2999,31540,"Madison, WI Metro Area",Bus,2009,371,466,837,0,
3000,31540,"Madison, WI Metro Area",Bus,2010,549,664,1213,0,
3001,31540,"Madison, WI Metro Area",Bus,2011,582,589,1171,0,
3002,31540,"Madison, WI Metro Area",Bus,2012,545,639,1184,0,
3003,31540,"Madison, WI Metro Area",Bus,2013,449,873,1322,0,
3004,31540,"Madison, WI Metro Area",Bus,2014,449,873,1322,0,
3005,31540,"Madison, WI Metro Area",Bus,2015,619,447,1066,0,
3006,31540,"Madison, WI Metro Area",Bus,2016,414,266,680,0,
3007,31540,"Madison, WI Metro Area",Bus,2017,303,230,533,0,
3008,31540,"Madison, WI Metro Area",Bus,2018,341,235,576,0,
3299,31700,"Manchester-Nashua, NH Metro Area",Bus,2002,0,0,0,1,
3301,31700,"Manchester-Nashua, NH Metro Area",Bus,2003,0,0,0,1,
3303,31700,"Manchester-Nashua, NH Metro Area",Bus,2004,0,0,0,1,
3305,31700,"Manchester-Nashua, NH Metro Area",Bus,2005,0,0,0,1,
3307,31700,"Manchester-Nashua, NH Metro Area",Bus,2006,0,0,0,1,
3309,31700,"Manchester-Nashua, NH Metro Area",Bus,2007,21,14,35,0,
3311,31700,"Manchester-Nashua, NH Metro Area",Bus,2008,17,16,33,0,
3313,31700,"Manchester-Nashua, NH Metro Area",Bus,2009,26,0,26,0,
3315,31700,"Manchester-Nashua, NH Metro Area",Bus,2010,21,5,26,0,
3317,31700,"Manchester-Nashua, NH Metro Area",Bus,2011,20,0,20,0,
3319,31700,"Manchester-Nashua, NH Metro Area",Bus,2012,20,0,20,0,
3321,31700,"Manchester-Nashua, NH Metro Area",Bus,2013,32,24,56,0,
3323,31700,"Manchester-Nashua, NH Metro Area",Bus,2014,51,28,79,0,
3325,31700,"Manchester-Nashua, NH Metro Area",Bus,2015,52,27,79,0,
3327,31700,"Manchester-Nashua, NH Metro Area",Bus,2016,50,26,76,0,
3329,31700,"Manchester-Nashua, NH Metro Area",Bus,2017,54,31,85,0,
3331,31700,"Manchester-Nashua, NH Metro Area",Bus,2018,42,22,64,0,
3009,32780,"Medford, OR Metro Area",Bus,2002,0,2,2,0,
3010,32780,"Medford, OR Metro Area",Bus,2003,0,7,7,0,
3011,32780,"Medford, OR Metro Area",Bus,2004,0,0,0,0,
3012,32780,"Medford, OR Metro Area",Bus,2005,1,3,4,0,
3013,32780,"Medford, OR Metro Area",Bus,2006,3,3,6,0,
3014,32780,"Medford, OR Metro Area",Bus,2007,6,3,9,0,
3015,32780,"Medford, OR Metro Area",Bus,2008,4,10,14,0,
3016,32780,"Medford, OR Metro Area",Bus,2009,38,29,67,0,
3017,32780,"Medford, OR Metro Area",Bus,2010,67,25,92,0,
3018,32780,"Medford, OR Metro Area",Bus,2011,74,59,133,0,
3019,32780,"Medford, OR Metro Area",Bus,2012,62,64,126,0,
3020,32780,"Medford, OR Metro Area",Bus,2013,45,113,158,0,
3021,32780,"Medford, OR Metro Area",Bus,2014,70,84,154,0,
3022,32780,"Medford, OR Metro Area",Bus,2015,60,171,231,0,
3023,32780,"Medford, OR Metro Area",Bus,2016,41,60,101,0,
3024,32780,"Medford, OR Metro Area",Bus,2017,84,79,163,0,
3025,32780,"Medford, OR Metro Area",Bus,2018,84,54,138,0,
3026,32820,"Memphis, TN-MS-AR Metro Area",Bus,2002,2614,1385,3999,0,
3027,32820,"Memphis, TN-MS-AR Metro Area",Bus,2003,1679,2112,3791,0,
3028,32820,"Memphis, TN-MS-AR Metro Area",Bus,2004,1442,2501,3943,0,
3029,32820,"Memphis, TN-MS-AR Metro Area",Bus,2005,1337,2487,3824,0,
3030,32820,"Memphis, TN-MS-AR Metro Area",Bus,2006,1434,2476,3910,0,
3031,32820,"Memphis, TN-MS-AR Metro Area",Bus,2007,1505,3103,4608,0,
3032,32820,"Memphis, TN-MS-AR Metro Area",Bus,2008,1468,2660,4128,0,
3033,32820,"Memphis, TN-MS-AR Metro Area",Bus,2009,1335,3156,4491,0,
3034,32820,"Memphis, TN-MS-AR Metro Area",Bus,2010,474,4061,4535,0,
3035,32820,"Memphis, TN-MS-AR Metro Area",Bus,2011,445,3748,4193,0,
3036,32820,"Memphis, TN-MS-AR Metro Area",Bus,2012,432,2777,3209,0,
3037,32820,"Memphis, TN-MS-AR Metro Area",Bus,2013,436,2395,2831,0,
3038,32820,"Memphis, TN-MS-AR Metro Area",Bus,2014,382,1903,2285,0,
3039,32820,"Memphis, TN-MS-AR Metro Area",Bus,2015,181,1479,1660,0,
3040,32820,"Memphis, TN-MS-AR Metro Area",Bus,2016,196,1523,1719,0,
3041,32820,"Memphis, TN-MS-AR Metro Area",Bus,2017,219,1707,1926,0,
3042,32820,"Memphis, TN-MS-AR Metro Area",Bus,2018,215,1604,1819,0,
3043,32900,"Merced, CA Metro Area",Bus,2002,0,0,0,1,
5168,32900,"Merced, CA Metro Area",Bus,2002,0,0,0,1,
3044,32900,"Merced, CA Metro Area",Bus,2003,0,0,0,1,
5170,32900,"Merced, CA Metro Area",Bus,2003,0,0,0,1,
3045,32900,"Merced, CA Metro Area",Bus,2004,0,0,0,1,
5172,32900,"Merced, CA Metro Area",Bus,2004,0,0,0,1,
3046,32900,"Merced, CA Metro Area",Bus,2005,0,0,0,1,
5174,32900,"Merced, CA Metro Area",Bus,2005,0,0,0,1,
3047,32900,"Merced, CA Metro Area",Bus,2006,0,0,0,1,
5176,32900,"Merced, CA Metro Area",Bus,2006,0,0,0,1,
3048,32900,"Merced, CA Metro Area",Bus,2007,0,0,0,1,
5178,32900,"Merced, CA Metro Area",Bus,2007,0,0,0,1,
3049,32900,"Merced, CA Metro Area",Bus,2008,9,258,267,1,
5180,32900,"Merced, CA Metro Area",Bus,2008,4,6,10,1,
3050,32900,"Merced, CA Metro Area",Bus,2009,7,225,232,1,
5182,32900,"Merced, CA Metro Area",Bus,2009,0,0,0,1,
3051,32900,"Merced, CA Metro Area",Bus,2010,6,210,216,1,
5184,32900,"Merced, CA Metro Area",Bus,2010,0,1,1,1,
3052,32900,"Merced, CA Metro Area",Bus,2011,7,197,204,1,
5186,32900,"Merced, CA Metro Area",Bus,2011,1,3,4,1,
3053,32900,"Merced, CA Metro Area",Bus,2012,4,24,28,1,
5188,32900,"Merced, CA Metro Area",Bus,2012,2,14,16,1,
3054,32900,"Merced, CA Metro Area",Bus,2013,34,108,142,1,
5190,32900,"Merced, CA Metro Area",Bus,2013,3,5,8,1,
3055,32900,"Merced, CA Metro Area",Bus,2014,19,79,98,1,
5192,32900,"Merced, CA Metro Area",Bus,2014,7,12,19,1,
3056,32900,"Merced, CA Metro Area",Bus,2015,16,60,76,1,
5194,32900,"Merced, CA Metro Area",Bus,2015,10,4,14,1,
3057,32900,"Merced, CA Metro Area",Bus,2016,25,21,46,1,
5196,32900,"Merced, CA Metro Area",Bus,2016,14,18,32,1,
3058,32900,"Merced, CA Metro Area",Bus,2017,22,26,48,1,
5198,32900,"Merced, CA Metro Area",Bus,2017,31,8,39,1,
3059,32900,"Merced, CA Metro Area",Bus,2018,23,42,65,1,
5200,32900,"Merced, CA Metro Area",Bus,2018,8,30,38,1,
3060,33100,"Miami-Fort Lauderdale-Pompano Beach, FL Metro Area",Bus,2002,13399,4369,17768,0,
3061,33100,"Miami-Fort Lauderdale-Pompano Beach, FL Metro Area",Bus,2003,8069,4876,12945,0,
3062,33100,"Miami-Fort Lauderdale-Pompano Beach, FL Metro Area",Bus,2004,8291,5969,14260,0,
3063,33100,"Miami-Fort Lauderdale-Pompano Beach, FL Metro Area",Bus,2005,9974,7503,17477,0,
3064,33100,"Miami-Fort Lauderdale-Pompano Beach, FL Metro Area",Bus,2006,11724,9096,20820,0,
3065,33100,"Miami-Fort Lauderdale-Pompano Beach, FL Metro Area",Bus,2007,9847,6479,16326,0,
3066,33100,"Miami-Fort Lauderdale-Pompano Beach, FL Metro Area",Bus,2008,9731,6941,16672,0,
3067,33100,"Miami-Fort Lauderdale-Pompano Beach, FL Metro Area",Bus,2009,10517,4834,15351,0,
3068,33100,"Miami-Fort Lauderdale-Pompano Beach, FL Metro Area",Bus,2010,8075,4340,12415,0,
3069,33100,"Miami-Fort Lauderdale-Pompano Beach, FL Metro Area",Bus,2011,7163,9336,16499,0,
3070,33100,"Miami-Fort Lauderdale-Pompano Beach, FL Metro Area",Bus,2012,7684,7258,14942,0,
3071,33100,"Miami-Fort Lauderdale-Pompano Beach, FL Metro Area",Bus,2013,8346,10265,18611,0,
3072,33100,"Miami-Fort Lauderdale-Pompano Beach, FL Metro Area",Bus,2014,11536,10716,22252,0,
3073,33100,"Miami-Fort Lauderdale-Pompano Beach, FL Metro Area",Bus,2015,13016,10638,23654,0,
3074,33100,"Miami-Fort Lauderdale-Pompano Beach, FL Metro Area",Bus,2016,13342,9738,23080,0,
3075,33100,"Miami-Fort Lauderdale-Pompano Beach, FL Metro Area",Bus,2017,7062,12445,19507,0,
3076,33100,"Miami-Fort Lauderdale-Pompano Beach, FL Metro Area",Bus,2018,8315,12389,20704,0,
3077,33100,"Miami-Fort Lauderdale-Pompano Beach, FL Metro Area",Rail,2002,2219,378,2597,0,
3078,33100,"Miami-Fort Lauderdale-Pompano Beach, FL Metro Area",Rail,2003,1908,388,2296,0,
3079,33100,"Miami-Fort Lauderdale-Pompano Beach, FL Metro Area",Rail,2004,1933,250,2183,0,
3080,33100,"Miami-Fort Lauderdale-Pompano Beach, FL Metro Area",Rail,2005,1677,625,2302,0,
3081,33100,"Miami-Fort Lauderdale-Pompano Beach, FL Metro Area",Rail,2006,1836,905,2741,0,
3082,33100,"Miami-Fort Lauderdale-Pompano Beach, FL Metro Area",Rail,2007,1705,774,2479,0,
3083,33100,"Miami-Fort Lauderdale-Pompano Beach, FL Metro Area",Rail,2008,1698,686,2384,0,
3084,33100,"Miami-Fort Lauderdale-Pompano Beach, FL Metro Area",Rail,2009,2763,748,3511,0,
3085,33100,"Miami-Fort Lauderdale-Pompano Beach, FL Metro Area",Rail,2010,2224,466,2690,0,
3086,33100,"Miami-Fort Lauderdale-Pompano Beach, FL Metro Area",Rail,2011,414,2472,2886,0,
3087,33100,"Miami-Fort Lauderdale-Pompano Beach, FL Metro Area",Rail,2012,467,2974,3441,0,
3088,33100,"Miami-Fort Lauderdale-Pompano Beach, FL Metro Area",Rail,2013,432,2655,3087,0,
3089,33100,"Miami-Fort Lauderdale-Pompano Beach, FL Metro Area",Rail,2014,476,2697,3173,0,
3090,33100,"Miami-Fort Lauderdale-Pompano Beach, FL Metro Area",Rail,2015,480,2678,3158,0,
3091,33100,"Miami-Fort Lauderdale-Pompano Beach, FL Metro Area",Rail,2016,297,2480,2777,0,
3092,33100,"Miami-Fort Lauderdale-Pompano Beach, FL Metro Area",Rail,2017,488,2297,2785,0,
3093,33100,"Miami-Fort Lauderdale-Pompano Beach, FL Metro Area",Rail,2018,561,1941,2502,0,
3094,33460,"Minneapolis-St. Paul-Bloomington, MN-WI Metro Area",Bus,2002,2149,16557,18706,0,
3095,33460,"Minneapolis-St. Paul-Bloomington, MN-WI Metro Area",Bus,2003,5778,4838,10616,0,
3096,33460,"Minneapolis-St. Paul-Bloomington, MN-WI Metro Area",Bus,2004,1459,7699,9158,0,
3097,33460,"Minneapolis-St. Paul-Bloomington, MN-WI Metro Area",Bus,2005,533,8758,9291,0,
3098,33460,"Minneapolis-St. Paul-Bloomington, MN-WI Metro Area",Bus,2006,800,8862,9662,0,
3099,33460,"Minneapolis-St. Paul-Bloomington, MN-WI Metro Area",Bus,2007,1079,9547,10626,0,
3100,33460,"Minneapolis-St. Paul-Bloomington, MN-WI Metro Area",Bus,2008,990,8836,9826,0,
3101,33460,"Minneapolis-St. Paul-Bloomington, MN-WI Metro Area",Bus,2009,1285,8496,9781,0,
3102,33460,"Minneapolis-St. Paul-Bloomington, MN-WI Metro Area",Bus,2010,1337,7682,9019,0,
3103,33460,"Minneapolis-St. Paul-Bloomington, MN-WI Metro Area",Bus,2011,1059,8456,9515,0,
3104,33460,"Minneapolis-St. Paul-Bloomington, MN-WI Metro Area",Bus,2012,648,7749,8397,0,
3105,33460,"Minneapolis-St. Paul-Bloomington, MN-WI Metro Area",Bus,2013,760,8315,9075,0,
3106,33460,"Minneapolis-St. Paul-Bloomington, MN-WI Metro Area",Bus,2014,896,8124,9020,0,
3107,33460,"Minneapolis-St. Paul-Bloomington, MN-WI Metro Area",Bus,2015,858,7680,8538,0,
3108,33460,"Minneapolis-St. Paul-Bloomington, MN-WI Metro Area",Bus,2016,739,6328,7067,0,
3109,33460,"Minneapolis-St. Paul-Bloomington, MN-WI Metro Area",Bus,2017,817,5957,6774,0,
3110,33460,"Minneapolis-St. Paul-Bloomington, MN-WI Metro Area",Bus,2018,684,6156,6840,0,
3111,33460,"Minneapolis-St. Paul-Bloomington, MN-WI Metro Area",Rail,2002,0,0,0,1,
3112,33460,"Minneapolis-St. Paul-Bloomington, MN-WI Metro Area",Rail,2003,0,0,0,1,
3113,33460,"Minneapolis-St. Paul-Bloomington, MN-WI Metro Area",Rail,2004,36,1,37,0,
3114,33460,"Minneapolis-St. Paul-Bloomington, MN-WI Metro Area",Rail,2005,0,57,57,0,
3115,33460,"Minneapolis-St. Paul-Bloomington, MN-WI Metro Area",Rail,2006,4,26,30,0,
3116,33460,"Minneapolis-St. Paul-Bloomington, MN-WI Metro Area",Rail,2007,3,42,45,0,
3117,33460,"Minneapolis-St. Paul-Bloomington, MN-WI Metro Area",Rail,2008,29,5,34,0,
3118,33460,"Minneapolis-St. Paul-Bloomington, MN-WI Metro Area",Rail,2009,98,94,192,0,
3119,33460,"Minneapolis-St. Paul-Bloomington, MN-WI Metro Area",Rail,2010,103,82,185,0,
3120,33460,"Minneapolis-St. Paul-Bloomington, MN-WI Metro Area",Rail,2011,108,87,195,0,
3121,33460,"Minneapolis-St. Paul-Bloomington, MN-WI Metro Area",Rail,2012,67,119,186,0,
3122,33460,"Minneapolis-St. Paul-Bloomington, MN-WI Metro Area",Rail,2013,81,58,139,0,
3123,33460,"Minneapolis-St. Paul-Bloomington, MN-WI Metro Area",Rail,2014,140,211,351,0,
3124,33460,"Minneapolis-St. Paul-Bloomington, MN-WI Metro Area",Rail,2015,179,169,348,0,
3125,33460,"Minneapolis-St. Paul-Bloomington, MN-WI Metro Area",Rail,2016,184,110,294,0,
3126,33460,"Minneapolis-St. Paul-Bloomington, MN-WI Metro Area",Rail,2017,103,132,235,0,
3127,33460,"Minneapolis-St. Paul-Bloomington, MN-WI Metro Area",Rail,2018,113,312,425,0,
3145,33540,"Missoula, MT Metro Area",Bus,2002,16,25,41,0,
3146,33540,"Missoula, MT Metro Area",Bus,2003,28,28,56,0,
3147,33540,"Missoula, MT Metro Area",Bus,2004,28,18,46,0,
3148,33540,"Missoula, MT Metro Area",Bus,2005,20,7,27,0,
3149,33540,"Missoula, MT Metro Area",Bus,2006,31,10,41,0,
3150,33540,"Missoula, MT Metro Area",Bus,2007,31,17,48,0,
3151,33540,"Missoula, MT Metro Area",Bus,2008,53,24,77,0,
3152,33540,"Missoula, MT Metro Area",Bus,2009,63,9,72,0,
3153,33540,"Missoula, MT Metro Area",Bus,2010,52,28,80,0,
3154,33540,"Missoula, MT Metro Area",Bus,2011,26,30,56,0,
3155,33540,"Missoula, MT Metro Area",Bus,2012,15,14,29,0,
3156,33540,"Missoula, MT Metro Area",Bus,2013,18,4,22,0,
3157,33540,"Missoula, MT Metro Area",Bus,2014,11,11,22,0,
3158,33540,"Missoula, MT Metro Area",Bus,2015,16,10,26,0,
3159,33540,"Missoula, MT Metro Area",Bus,2016,15,8,23,0,
3160,33540,"Missoula, MT Metro Area",Bus,2017,28,31,59,0,
3161,33540,"Missoula, MT Metro Area",Bus,2018,60,67,127,0,
3162,33660,"Mobile, AL Metro Area",Bus,2002,0,0,0,1,
3163,33660,"Mobile, AL Metro Area",Bus,2003,359,145,504,0,
3164,33660,"Mobile, AL Metro Area",Bus,2004,360,108,468,0,
3165,33660,"Mobile, AL Metro Area",Bus,2005,199,89,288,0,
3166,33660,"Mobile, AL Metro Area",Bus,2006,163,98,261,0,
3167,33660,"Mobile, AL Metro Area",Bus,2007,183,107,290,0,
3168,33660,"Mobile, AL Metro Area",Bus,2008,71,217,288,0,
3169,33660,"Mobile, AL Metro Area",Bus,2009,54,223,277,0,
3170,33660,"Mobile, AL Metro Area",Bus,2010,14,188,202,0,
3171,33660,"Mobile, AL Metro Area",Bus,2011,49,42,91,0,
3172,33660,"Mobile, AL Metro Area",Bus,2012,39,40,79,0,
3173,33660,"Mobile, AL Metro Area",Bus,2013,52,92,144,0,
3174,33660,"Mobile, AL Metro Area",Bus,2014,74,149,223,0,
3175,33660,"Mobile, AL Metro Area",Bus,2015,119,166,285,0,
3176,33660,"Mobile, AL Metro Area",Bus,2016,101,163,264,0,
3177,33660,"Mobile, AL Metro Area",Bus,2017,45,124,169,0,
3178,33660,"Mobile, AL Metro Area",Bus,2018,45,153,198,0,
3179,33700,"Modesto, CA Metro Area",Bus,2002,0,0,0,1,
5169,33700,"Modesto, CA Metro Area",Bus,2002,0,0,0,1,
3180,33700,"Modesto, CA Metro Area",Bus,2003,0,0,0,1,
5171,33700,"Modesto, CA Metro Area",Bus,2003,0,0,0,1,
3181,33700,"Modesto, CA Metro Area",Bus,2004,0,0,0,1,
5173,33700,"Modesto, CA Metro Area",Bus,2004,0,0,0,1,
3182,33700,"Modesto, CA Metro Area",Bus,2005,0,0,0,1,
5175,33700,"Modesto, CA Metro Area",Bus,2005,0,0,0,1,
3183,33700,"Modesto, CA Metro Area",Bus,2006,0,0,0,1,
5177,33700,"Modesto, CA Metro Area",Bus,2006,0,0,0,1,
3184,33700,"Modesto, CA Metro Area",Bus,2007,0,0,0,1,
5179,33700,"Modesto, CA Metro Area",Bus,2007,0,0,0,1,
3185,33700,"Modesto, CA Metro Area",Bus,2008,0,0,0,1,
5181,33700,"Modesto, CA Metro Area",Bus,2008,4,6,10,0,
3186,33700,"Modesto, CA Metro Area",Bus,2009,73,38,111,0,
5183,33700,"Modesto, CA Metro Area",Bus,2009,0,0,0,0,
3187,33700,"Modesto, CA Metro Area",Bus,2010,102,42,144,0,
5185,33700,"Modesto, CA Metro Area",Bus,2010,0,1,1,0,
3188,33700,"Modesto, CA Metro Area",Bus,2011,96,52,148,0,
5187,33700,"Modesto, CA Metro Area",Bus,2011,1,3,4,0,
3189,33700,"Modesto, CA Metro Area",Bus,2012,105,35,140,0,
5189,33700,"Modesto, CA Metro Area",Bus,2012,2,14,16,0,
3190,33700,"Modesto, CA Metro Area",Bus,2013,90,23,113,0,
5191,33700,"Modesto, CA Metro Area",Bus,2013,3,5,8,0,
3191,33700,"Modesto, CA Metro Area",Bus,2014,43,11,54,0,
5193,33700,"Modesto, CA Metro Area",Bus,2014,7,12,19,0,
3192,33700,"Modesto, CA Metro Area",Bus,2015,53,8,61,0,
5195,33700,"Modesto, CA Metro Area",Bus,2015,10,4,14,0,
3193,33700,"Modesto, CA Metro Area",Bus,2016,23,2,25,0,
5197,33700,"Modesto, CA Metro Area",Bus,2016,14,18,32,0,
3194,33700,"Modesto, CA Metro Area",Bus,2017,30,5,35,0,
5199,33700,"Modesto, CA Metro Area",Bus,2017,31,8,39,0,
3195,33700,"Modesto, CA Metro Area",Bus,2018,27,5,32,0,
5201,33700,"Modesto, CA Metro Area",Bus,2018,8,30,38,0,
3213,33860,"Montgomery, AL Metro Area",Bus,2002,97,6,103,0,
3214,33860,"Montgomery, AL Metro Area",Bus,2003,0,67,67,0,
3215,33860,"Montgomery, AL Metro Area",Bus,2004,77,0,77,0,
3216,33860,"Montgomery, AL Metro Area",Bus,2005,104,0,104,0,
3217,33860,"Montgomery, AL Metro Area",Bus,2006,80,0,80,0,
3218,33860,"Montgomery, AL Metro Area",Bus,2007,107,0,107,0,
3219,33860,"Montgomery, AL Metro Area",Bus,2008,131,0,131,0,
3220,33860,"Montgomery, AL Metro Area",Bus,2009,165,12,177,0,
3221,33860,"Montgomery, AL Metro Area",Bus,2010,119,20,139,0,
3222,33860,"Montgomery, AL Metro Area",Bus,2011,127,25,152,0,
3223,33860,"Montgomery, AL Metro Area",Bus,2012,95,23,118,0,
3224,33860,"Montgomery, AL Metro Area",Bus,2013,90,13,103,0,
3225,33860,"Montgomery, AL Metro Area",Bus,2014,124,24,148,0,
3226,33860,"Montgomery, AL Metro Area",Bus,2015,60,14,74,0,
3227,33860,"Montgomery, AL Metro Area",Bus,2016,55,22,77,0,
3228,33860,"Montgomery, AL Metro Area",Bus,2017,65,34,99,0,
3229,33860,"Montgomery, AL Metro Area",Bus,2018,55,27,82,0,
3230,34060,"Morgantown, WV Metro Area",Rail,2002,0,0,0,1,
3231,34060,"Morgantown, WV Metro Area",Rail,2003,0,0,0,1,
3232,34060,"Morgantown, WV Metro Area",Rail,2004,0,0,0,1,
3233,34060,"Morgantown, WV Metro Area",Rail,2005,0,0,0,1,
3234,34060,"Morgantown, WV Metro Area",Rail,2006,0,0,0,1,
3235,34060,"Morgantown, WV Metro Area",Rail,2007,0,0,0,1,
3236,34060,"Morgantown, WV Metro Area",Rail,2008,0,0,0,1,
3237,34060,"Morgantown, WV Metro Area",Rail,2009,0,0,0,1,
3238,34060,"Morgantown, WV Metro Area",Rail,2010,0,0,0,1,
3239,34060,"Morgantown, WV Metro Area",Rail,2011,0,0,0,1,
3240,34060,"Morgantown, WV Metro Area",Rail,2012,234,225,459,0,
3241,34060,"Morgantown, WV Metro Area",Rail,2013,251,181,432,0,
3242,34060,"Morgantown, WV Metro Area",Rail,2014,246,189,435,0,
3243,34060,"Morgantown, WV Metro Area",Rail,2015,245,184,429,0,
3244,34060,"Morgantown, WV Metro Area",Rail,2016,288,224,512,0,
3245,34060,"Morgantown, WV Metro Area",Rail,2017,301,237,538,0,
3246,34060,"Morgantown, WV Metro Area",Rail,2018,189,261,450,0,
3247,34580,"Mount Vernon-Anacortes, WA Metro Area",Bus,2002,0,0,0,1,
3248,34580,"Mount Vernon-Anacortes, WA Metro Area",Bus,2003,0,0,0,1,
3249,34580,"Mount Vernon-Anacortes, WA Metro Area",Bus,2004,21,6,27,0,
3250,34580,"Mount Vernon-Anacortes, WA Metro Area",Bus,2005,25,9,34,0,
3251,34580,"Mount Vernon-Anacortes, WA Metro Area",Bus,2006,41,167,208,0,
3252,34580,"Mount Vernon-Anacortes, WA Metro Area",Bus,2007,30,9,39,0,
3253,34580,"Mount Vernon-Anacortes, WA Metro Area",Bus,2008,33,4,37,0,
3254,34580,"Mount Vernon-Anacortes, WA Metro Area",Bus,2009,28,7,35,0,
3255,34580,"Mount Vernon-Anacortes, WA Metro Area",Bus,2010,17,1,18,0,
3256,34580,"Mount Vernon-Anacortes, WA Metro Area",Bus,2011,19,1,20,0,
3257,34580,"Mount Vernon-Anacortes, WA Metro Area",Bus,2012,23,11,34,0,
3258,34580,"Mount Vernon-Anacortes, WA Metro Area",Bus,2013,17,1,18,0,
3259,34580,"Mount Vernon-Anacortes, WA Metro Area",Bus,2014,21,4,25,0,
3260,34580,"Mount Vernon-Anacortes, WA Metro Area",Bus,2015,16,10,26,0,
3261,34580,"Mount Vernon-Anacortes, WA Metro Area",Bus,2016,17,4,21,0,
3262,34580,"Mount Vernon-Anacortes, WA Metro Area",Bus,2017,35,7,42,0,
3263,34580,"Mount Vernon-Anacortes, WA Metro Area",Bus,2018,22,17,39,0,
3264,34620,"Muncie, IN Metro Area",Bus,2002,39,100,139,0,
3265,34620,"Muncie, IN Metro Area",Bus,2003,28,90,118,0,
3266,34620,"Muncie, IN Metro Area",Bus,2004,30,104,134,0,
3267,34620,"Muncie, IN Metro Area",Bus,2005,30,117,147,0,
3268,34620,"Muncie, IN Metro Area",Bus,2006,16,81,97,0,
3269,34620,"Muncie, IN Metro Area",Bus,2007,10,46,56,0,
3270,34620,"Muncie, IN Metro Area",Bus,2008,7,52,59,0,
3271,34620,"Muncie, IN Metro Area",Bus,2009,10,44,54,0,
3272,34620,"Muncie, IN Metro Area",Bus,2010,21,40,61,0,
3273,34620,"Muncie, IN Metro Area",Bus,2011,8,45,53,0,
3274,34620,"Muncie, IN Metro Area",Bus,2012,6,28,34,0,
3275,34620,"Muncie, IN Metro Area",Bus,2013,8,19,27,0,
3276,34620,"Muncie, IN Metro Area",Bus,2014,1,0,1,0,
3277,34620,"Muncie, IN Metro Area",Bus,2015,0,26,26,0,
3278,34620,"Muncie, IN Metro Area",Bus,2016,0,32,32,0,
3279,34620,"Muncie, IN Metro Area",Bus,2017,0,24,24,0,
3280,34620,"Muncie, IN Metro Area",Bus,2018,0,37,37,0,
3281,34900,"Napa, CA Metro Area",Bus,2002,0,0,0,1,
5236,34900,"Napa, CA Metro Area",Bus,2002,0,0,0,1,
3282,34900,"Napa, CA Metro Area",Bus,2003,0,0,0,1,
5238,34900,"Napa, CA Metro Area",Bus,2003,0,0,0,1,
3283,34900,"Napa, CA Metro Area",Bus,2004,0,0,0,1,
5240,34900,"Napa, CA Metro Area",Bus,2004,0,0,0,1,
3284,34900,"Napa, CA Metro Area",Bus,2005,0,0,0,1,
5242,34900,"Napa, CA Metro Area",Bus,2005,0,0,0,1,
3285,34900,"Napa, CA Metro Area",Bus,2006,0,0,0,1,
5244,34900,"Napa, CA Metro Area",Bus,2006,0,0,0,1,
3286,34900,"Napa, CA Metro Area",Bus,2007,0,0,0,1,
5246,34900,"Napa, CA Metro Area",Bus,2007,0,0,0,1,
3287,34900,"Napa, CA Metro Area",Bus,2008,0,0,0,1,
5248,34900,"Napa, CA Metro Area",Bus,2008,0,0,0,1,
3288,34900,"Napa, CA Metro Area",Bus,2009,10,6,16,1,
5250,34900,"Napa, CA Metro Area",Bus,2009,0,0,0,1,
3289,34900,"Napa, CA Metro Area",Bus,2010,2,14,16,1,
5252,34900,"Napa, CA Metro Area",Bus,2010,0,0,0,1,
3290,34900,"Napa, CA Metro Area",Bus,2011,4,5,9,1,
5254,34900,"Napa, CA Metro Area",Bus,2011,0,0,0,1,
3291,34900,"Napa, CA Metro Area",Bus,2012,27,7,34,1,
5256,34900,"Napa, CA Metro Area",Bus,2012,14,24,38,1,
3292,34900,"Napa, CA Metro Area",Bus,2013,70,8,78,0,
5258,34900,"Napa, CA Metro Area",Bus,2013,83,147,230,0,
3293,34900,"Napa, CA Metro Area",Bus,2014,25,37,62,0,
5260,34900,"Napa, CA Metro Area",Bus,2014,209,159,368,0,
3294,34900,"Napa, CA Metro Area",Bus,2015,43,5,48,0,
5262,34900,"Napa, CA Metro Area",Bus,2015,167,85,252,0,
3295,34900,"Napa, CA Metro Area",Bus,2016,7,26,33,0,
5264,34900,"Napa, CA Metro Area",Bus,2016,215,53,268,0,
3296,34900,"Napa, CA Metro Area",Bus,2017,2,50,52,0,
5266,34900,"Napa, CA Metro Area",Bus,2017,262,55,317,0,
3297,34900,"Napa, CA Metro Area",Bus,2018,15,37,52,0,
5268,34900,"Napa, CA Metro Area",Bus,2018,190,40,230,0,
596,34940,"Naples-Marco Island, FL Metro Area",Bus,2002,0,0,0,1,
598,34940,"Naples-Marco Island, FL Metro Area",Bus,2003,0,0,0,1,
600,34940,"Naples-Marco Island, FL Metro Area",Bus,2004,0,0,0,1,
602,34940,"Naples-Marco Island, FL Metro Area",Bus,2005,0,0,0,1,
604,34940,"Naples-Marco Island, FL Metro Area",Bus,2006,0,0,0,1,
606,34940,"Naples-Marco Island, FL Metro Area",Bus,2007,0,0,0,1,
608,34940,"Naples-Marco Island, FL Metro Area",Bus,2008,0,0,0,1,
610,34940,"Naples-Marco Island, FL Metro Area",Bus,2009,109,33,142,0,
612,34940,"Naples-Marco Island, FL Metro Area",Bus,2010,105,21,126,0,
614,34940,"Naples-Marco Island, FL Metro Area",Bus,2011,77,11,88,0,
616,34940,"Naples-Marco Island, FL Metro Area",Bus,2012,68,9,77,0,
618,34940,"Naples-Marco Island, FL Metro Area",Bus,2013,52,2,54,0,
620,34940,"Naples-Marco Island, FL Metro Area",Bus,2014,28,1,29,0,
622,34940,"Naples-Marco Island, FL Metro Area",Bus,2015,31,0,31,0,
624,34940,"Naples-Marco Island, FL Metro Area",Bus,2016,23,0,23,0,
626,34940,"Naples-Marco Island, FL Metro Area",Bus,2017,94,27,121,0,
628,34940,"Naples-Marco Island, FL Metro Area",Bus,2018,98,54,152,0,
3332,34980,"Nashville-Davidson--Murfreesboro--Franklin, TN Metro Area",Bus,2002,240,860,1100,0,
3333,34980,"Nashville-Davidson--Murfreesboro--Franklin, TN Metro Area",Bus,2003,292,1034,1326,0,
3334,34980,"Nashville-Davidson--Murfreesboro--Franklin, TN Metro Area",Bus,2004,297,1234,1531,0,
3335,34980,"Nashville-Davidson--Murfreesboro--Franklin, TN Metro Area",Bus,2005,110,875,985,0,
3336,34980,"Nashville-Davidson--Murfreesboro--Franklin, TN Metro Area",Bus,2006,640,497,1137,0,
3337,34980,"Nashville-Davidson--Murfreesboro--Franklin, TN Metro Area",Bus,2007,773,499,1272,0,
3338,34980,"Nashville-Davidson--Murfreesboro--Franklin, TN Metro Area",Bus,2008,784,715,1499,0,
3339,34980,"Nashville-Davidson--Murfreesboro--Franklin, TN Metro Area",Bus,2009,704,567,1271,0,
3340,34980,"Nashville-Davidson--Murfreesboro--Franklin, TN Metro Area",Bus,2010,817,576,1393,0,
3341,34980,"Nashville-Davidson--Murfreesboro--Franklin, TN Metro Area",Bus,2011,888,471,1359,0,
3342,34980,"Nashville-Davidson--Murfreesboro--Franklin, TN Metro Area",Bus,2012,660,372,1032,0,
3343,34980,"Nashville-Davidson--Murfreesboro--Franklin, TN Metro Area",Bus,2013,730,258,988,0,
3344,34980,"Nashville-Davidson--Murfreesboro--Franklin, TN Metro Area",Bus,2014,882,279,1161,0,
3345,34980,"Nashville-Davidson--Murfreesboro--Franklin, TN Metro Area",Bus,2015,609,276,885,0,
3346,34980,"Nashville-Davidson--Murfreesboro--Franklin, TN Metro Area",Bus,2016,908,377,1285,0,
3347,34980,"Nashville-Davidson--Murfreesboro--Franklin, TN Metro Area",Bus,2017,1036,149,1185,0,
3348,34980,"Nashville-Davidson--Murfreesboro--Franklin, TN Metro Area",Bus,2018,2362,914,3276,0,
3349,34980,"Nashville-Davidson--Murfreesboro--Franklin, TN Metro Area",Rail,2002,0,0,0,0,
3350,34980,"Nashville-Davidson--Murfreesboro--Franklin, TN Metro Area",Rail,2003,0,0,0,0,
3351,34980,"Nashville-Davidson--Murfreesboro--Franklin, TN Metro Area",Rail,2004,0,0,0,0,
3352,34980,"Nashville-Davidson--Murfreesboro--Franklin, TN Metro Area",Rail,2005,0,0,0,0,
3353,34980,"Nashville-Davidson--Murfreesboro--Franklin, TN Metro Area",Rail,2006,0,0,0,0,
3354,34980,"Nashville-Davidson--Murfreesboro--Franklin, TN Metro Area",Rail,2007,0,0,0,0,
3355,34980,"Nashville-Davidson--Murfreesboro--Franklin, TN Metro Area",Rail,2008,1,0,1,0,
3356,34980,"Nashville-Davidson--Murfreesboro--Franklin, TN Metro Area",Rail,2009,1,0,1,0,
3357,34980,"Nashville-Davidson--Murfreesboro--Franklin, TN Metro Area",Rail,2010,0,0,0,0,
3358,34980,"Nashville-Davidson--Murfreesboro--Franklin, TN Metro Area",Rail,2011,5,3,8,0,
3359,34980,"Nashville-Davidson--Murfreesboro--Franklin, TN Metro Area",Rail,2012,5,4,9,0,
3360,34980,"Nashville-Davidson--Murfreesboro--Franklin, TN Metro Area",Rail,2013,5,2,7,0,
3361,34980,"Nashville-Davidson--Murfreesboro--Franklin, TN Metro Area",Rail,2014,3,0,3,0,
3362,34980,"Nashville-Davidson--Murfreesboro--Franklin, TN Metro Area",Rail,2015,0,0,0,0,
3363,34980,"Nashville-Davidson--Murfreesboro--Franklin, TN Metro Area",Rail,2016,3,0,3,0,
3364,34980,"Nashville-Davidson--Murfreesboro--Franklin, TN Metro Area",Rail,2017,3,5,8,0,
3365,34980,"Nashville-Davidson--Murfreesboro--Franklin, TN Metro Area",Rail,2018,4,0,4,0,
681,35300,"New Haven-Milford, CT Metro Area",Bus,2002,885,729,1614,0,
3383,35300,"New Haven-Milford, CT Metro Area",Bus,2002,929,689,1618,0,
5406,35300,"New Haven-Milford, CT Metro Area",Bus,2002,49,77,126,0,
683,35300,"New Haven-Milford, CT Metro Area",Bus,2003,939,653,1592,0,
3384,35300,"New Haven-Milford, CT Metro Area",Bus,2003,1138,850,1988,0,
5407,35300,"New Haven-Milford, CT Metro Area",Bus,2003,50,109,159,0,
685,35300,"New Haven-Milford, CT Metro Area",Bus,2004,1058,746,1804,0,
3385,35300,"New Haven-Milford, CT Metro Area",Bus,2004,1049,705,1754,0,
5408,35300,"New Haven-Milford, CT Metro Area",Bus,2004,28,79,107,0,
687,35300,"New Haven-Milford, CT Metro Area",Bus,2005,1251,1009,2260,0,
3386,35300,"New Haven-Milford, CT Metro Area",Bus,2005,619,1007,1626,0,
5409,35300,"New Haven-Milford, CT Metro Area",Bus,2005,28,103,131,0,
689,35300,"New Haven-Milford, CT Metro Area",Bus,2006,1176,777,1953,0,
3387,35300,"New Haven-Milford, CT Metro Area",Bus,2006,666,1314,1980,0,
5410,35300,"New Haven-Milford, CT Metro Area",Bus,2006,29,82,111,0,
691,35300,"New Haven-Milford, CT Metro Area",Bus,2007,1154,711,1865,0,
3388,35300,"New Haven-Milford, CT Metro Area",Bus,2007,731,1415,2146,0,
5411,35300,"New Haven-Milford, CT Metro Area",Bus,2007,55,66,121,0,
693,35300,"New Haven-Milford, CT Metro Area",Bus,2008,1311,859,2170,0,
3389,35300,"New Haven-Milford, CT Metro Area",Bus,2008,769,1296,2065,0,
5412,35300,"New Haven-Milford, CT Metro Area",Bus,2008,61,50,111,0,
695,35300,"New Haven-Milford, CT Metro Area",Bus,2009,1572,680,2252,0,
3390,35300,"New Haven-Milford, CT Metro Area",Bus,2009,813,1385,2198,0,
5413,35300,"New Haven-Milford, CT Metro Area",Bus,2009,61,29,90,0,
697,35300,"New Haven-Milford, CT Metro Area",Bus,2010,1524,660,2184,0,
3391,35300,"New Haven-Milford, CT Metro Area",Bus,2010,984,1525,2509,0,
5414,35300,"New Haven-Milford, CT Metro Area",Bus,2010,63,36,99,0,
699,35300,"New Haven-Milford, CT Metro Area",Bus,2011,1239,652,1891,0,
3392,35300,"New Haven-Milford, CT Metro Area",Bus,2011,1015,1373,2388,0,
5415,35300,"New Haven-Milford, CT Metro Area",Bus,2011,73,42,115,0,
701,35300,"New Haven-Milford, CT Metro Area",Bus,2012,1100,668,1768,0,
3393,35300,"New Haven-Milford, CT Metro Area",Bus,2012,955,2431,3386,0,
5416,35300,"New Haven-Milford, CT Metro Area",Bus,2012,33,25,58,0,
703,35300,"New Haven-Milford, CT Metro Area",Bus,2013,754,819,1573,0,
3394,35300,"New Haven-Milford, CT Metro Area",Bus,2013,587,1942,2529,0,
5417,35300,"New Haven-Milford, CT Metro Area",Bus,2013,51,68,119,0,
705,35300,"New Haven-Milford, CT Metro Area",Bus,2014,659,831,1490,0,
3395,35300,"New Haven-Milford, CT Metro Area",Bus,2014,339,2349,2688,0,
5418,35300,"New Haven-Milford, CT Metro Area",Bus,2014,37,49,86,0,
707,35300,"New Haven-Milford, CT Metro Area",Bus,2015,599,696,1295,0,
3396,35300,"New Haven-Milford, CT Metro Area",Bus,2015,319,2236,2555,0,
5419,35300,"New Haven-Milford, CT Metro Area",Bus,2015,61,26,87,0,
709,35300,"New Haven-Milford, CT Metro Area",Bus,2016,641,774,1415,0,
3397,35300,"New Haven-Milford, CT Metro Area",Bus,2016,375,1709,2084,0,
5420,35300,"New Haven-Milford, CT Metro Area",Bus,2016,67,19,86,0,
711,35300,"New Haven-Milford, CT Metro Area",Bus,2017,616,1016,1632,0,
3398,35300,"New Haven-Milford, CT Metro Area",Bus,2017,265,1390,1655,0,
5421,35300,"New Haven-Milford, CT Metro Area",Bus,2017,44,9,53,0,
713,35300,"New Haven-Milford, CT Metro Area",Bus,2018,352,1057,1409,0,
3399,35300,"New Haven-Milford, CT Metro Area",Bus,2018,178,1331,1509,0,
5422,35300,"New Haven-Milford, CT Metro Area",Bus,2018,29,33,62,0,
3400,35380,"New Orleans-Metairie-Kenner, LA Metro Area",Bus,2002,2498,4413,6911,0,
3401,35380,"New Orleans-Metairie-Kenner, LA Metro Area",Bus,2003,1971,3627,5598,0,
3402,35380,"New Orleans-Metairie-Kenner, LA Metro Area",Bus,2004,2127,3079,5206,0,
3403,35380,"New Orleans-Metairie-Kenner, LA Metro Area",Bus,2005,0,0,0,0,
3404,35380,"New Orleans-Metairie-Kenner, LA Metro Area",Bus,2006,2330,1679,4009,0,
3405,35380,"New Orleans-Metairie-Kenner, LA Metro Area",Bus,2007,1231,496,1727,0,
3406,35380,"New Orleans-Metairie-Kenner, LA Metro Area",Bus,2008,967,420,1387,0,
3407,35380,"New Orleans-Metairie-Kenner, LA Metro Area",Bus,2009,1261,986,2247,0,
3408,35380,"New Orleans-Metairie-Kenner, LA Metro Area",Bus,2010,532,842,1374,0,
3409,35380,"New Orleans-Metairie-Kenner, LA Metro Area",Bus,2011,330,736,1066,0,
3410,35380,"New Orleans-Metairie-Kenner, LA Metro Area",Bus,2012,272,564,836,0,
3411,35380,"New Orleans-Metairie-Kenner, LA Metro Area",Bus,2013,445,697,1142,0,
3412,35380,"New Orleans-Metairie-Kenner, LA Metro Area",Bus,2014,491,917,1408,0,
3413,35380,"New Orleans-Metairie-Kenner, LA Metro Area",Bus,2015,705,840,1545,0,
3414,35380,"New Orleans-Metairie-Kenner, LA Metro Area",Bus,2016,694,918,1612,0,
3415,35380,"New Orleans-Metairie-Kenner, LA Metro Area",Bus,2017,616,943,1559,0,
3416,35380,"New Orleans-Metairie-Kenner, LA Metro Area",Bus,2018,733,1018,1751,0,
3417,35380,"New Orleans-Metairie-Kenner, LA Metro Area",Rail,2002,96,44,140,0,
3418,35380,"New Orleans-Metairie-Kenner, LA Metro Area",Rail,2003,71,62,133,0,
3419,35380,"New Orleans-Metairie-Kenner, LA Metro Area",Rail,2004,137,62,199,0,
3420,35380,"New Orleans-Metairie-Kenner, LA Metro Area",Rail,2005,0,0,0,1,
3421,35380,"New Orleans-Metairie-Kenner, LA Metro Area",Rail,2006,105,26,131,0,
3422,35380,"New Orleans-Metairie-Kenner, LA Metro Area",Rail,2007,56,15,71,0,
3423,35380,"New Orleans-Metairie-Kenner, LA Metro Area",Rail,2008,111,36,147,0,
3424,35380,"New Orleans-Metairie-Kenner, LA Metro Area",Rail,2009,293,143,436,0,
3425,35380,"New Orleans-Metairie-Kenner, LA Metro Area",Rail,2010,233,382,615,0,
3426,35380,"New Orleans-Metairie-Kenner, LA Metro Area",Rail,2011,120,77,197,0,
3427,35380,"New Orleans-Metairie-Kenner, LA Metro Area",Rail,2012,74,54,128,0,
3428,35380,"New Orleans-Metairie-Kenner, LA Metro Area",Rail,2013,91,61,152,0,
3429,35380,"New Orleans-Metairie-Kenner, LA Metro Area",Rail,2014,97,70,167,0,
3430,35380,"New Orleans-Metairie-Kenner, LA Metro Area",Rail,2015,46,58,104,0,
3431,35380,"New Orleans-Metairie-Kenner, LA Metro Area",Rail,2016,75,87,162,0,
3432,35380,"New Orleans-Metairie-Kenner, LA Metro Area",Rail,2017,33,114,147,0,
3433,35380,"New Orleans-Metairie-Kenner, LA Metro Area",Rail,2018,37,129,166,0,
3434,35620,"New York-Northern New Jersey-Long Island, NY-NJ-PA Metro Area",Bus,2002,24808,17348,42156,0,
3435,35620,"New York-Northern New Jersey-Long Island, NY-NJ-PA Metro Area",Bus,2003,31091,11300,42391,0,
3436,35620,"New York-Northern New Jersey-Long Island, NY-NJ-PA Metro Area",Bus,2004,31805,10523,42328,0,
3437,35620,"New York-Northern New Jersey-Long Island, NY-NJ-PA Metro Area",Bus,2005,31435,9442,40877,0,
3438,35620,"New York-Northern New Jersey-Long Island, NY-NJ-PA Metro Area",Bus,2006,29796,8661,38457,0,
3439,35620,"New York-Northern New Jersey-Long Island, NY-NJ-PA Metro Area",Bus,2007,28627,8485,37112,0,
3440,35620,"New York-Northern New Jersey-Long Island, NY-NJ-PA Metro Area",Bus,2008,31746,8448,40194,0,
3441,35620,"New York-Northern New Jersey-Long Island, NY-NJ-PA Metro Area",Bus,2009,33842,9214,43056,0,
3442,35620,"New York-Northern New Jersey-Long Island, NY-NJ-PA Metro Area",Bus,2010,32776,9445,42221,0,
3443,35620,"New York-Northern New Jersey-Long Island, NY-NJ-PA Metro Area",Bus,2011,32063,9795,41858,0,
3444,35620,"New York-Northern New Jersey-Long Island, NY-NJ-PA Metro Area",Bus,2012,28307,9088,37395,0,
3445,35620,"New York-Northern New Jersey-Long Island, NY-NJ-PA Metro Area",Bus,2013,26250,10737,36987,0,
3446,35620,"New York-Northern New Jersey-Long Island, NY-NJ-PA Metro Area",Bus,2014,30922,11622,42544,0,
3447,35620,"New York-Northern New Jersey-Long Island, NY-NJ-PA Metro Area",Bus,2015,26401,12472,38873,0,
3448,35620,"New York-Northern New Jersey-Long Island, NY-NJ-PA Metro Area",Bus,2016,21781,12515,34296,0,
3449,35620,"New York-Northern New Jersey-Long Island, NY-NJ-PA Metro Area",Bus,2017,21368,12186,33554,0,
3450,35620,"New York-Northern New Jersey-Long Island, NY-NJ-PA Metro Area",Bus,2018,20857,10694,31551,0,
3451,35620,"New York-Northern New Jersey-Long Island, NY-NJ-PA Metro Area",Rail,2002,4740,7923,12663,0,
3452,35620,"New York-Northern New Jersey-Long Island, NY-NJ-PA Metro Area",Rail,2003,3486,6065,9551,0,
3453,35620,"New York-Northern New Jersey-Long Island, NY-NJ-PA Metro Area",Rail,2004,3318,6412,9730,0,
3454,35620,"New York-Northern New Jersey-Long Island, NY-NJ-PA Metro Area",Rail,2005,2951,6486,9437,0,
3455,35620,"New York-Northern New Jersey-Long Island, NY-NJ-PA Metro Area",Rail,2006,2976,7828,10804,0,
3456,35620,"New York-Northern New Jersey-Long Island, NY-NJ-PA Metro Area",Rail,2007,3099,8419,11518,0,
3457,35620,"New York-Northern New Jersey-Long Island, NY-NJ-PA Metro Area",Rail,2008,3451,8960,12411,0,
3458,35620,"New York-Northern New Jersey-Long Island, NY-NJ-PA Metro Area",Rail,2009,3669,8362,12031,0,
3459,35620,"New York-Northern New Jersey-Long Island, NY-NJ-PA Metro Area",Rail,2010,3635,8104,11739,0,
3460,35620,"New York-Northern New Jersey-Long Island, NY-NJ-PA Metro Area",Rail,2011,3257,7809,11066,0,
3461,35620,"New York-Northern New Jersey-Long Island, NY-NJ-PA Metro Area",Rail,2012,2937,8126,11063,0,
3462,35620,"New York-Northern New Jersey-Long Island, NY-NJ-PA Metro Area",Rail,2013,3082,8670,11752,0,
3463,35620,"New York-Northern New Jersey-Long Island, NY-NJ-PA Metro Area",Rail,2014,3364,10572,13936,0,
3464,35620,"New York-Northern New Jersey-Long Island, NY-NJ-PA Metro Area",Rail,2015,3411,10479,13890,0,
3465,35620,"New York-Northern New Jersey-Long Island, NY-NJ-PA Metro Area",Rail,2016,3929,10305,14234,0,
3466,35620,"New York-Northern New Jersey-Long Island, NY-NJ-PA Metro Area",Rail,2017,3807,11057,14864,0,
3467,35620,"New York-Northern New Jersey-Long Island, NY-NJ-PA Metro Area",Rail,2018,4077,12750,16827,0,
4743,35660,"Niles-Benton Harbor, MI Metro Area",Bus,2002,108,57,165,0,
4745,35660,"Niles-Benton Harbor, MI Metro Area",Bus,2003,40,26,66,0,
4747,35660,"Niles-Benton Harbor, MI Metro Area",Bus,2004,39,7,46,0,
4749,35660,"Niles-Benton Harbor, MI Metro Area",Bus,2005,113,23,136,0,
4751,35660,"Niles-Benton Harbor, MI Metro Area",Bus,2006,51,16,67,0,
4753,35660,"Niles-Benton Harbor, MI Metro Area",Bus,2007,85,24,109,0,
4755,35660,"Niles-Benton Harbor, MI Metro Area",Bus,2008,128,16,144,0,
4757,35660,"Niles-Benton Harbor, MI Metro Area",Bus,2009,130,24,154,0,
4759,35660,"Niles-Benton Harbor, MI Metro Area",Bus,2010,204,26,230,0,
4761,35660,"Niles-Benton Harbor, MI Metro Area",Bus,2011,106,6,112,0,
4763,35660,"Niles-Benton Harbor, MI Metro Area",Bus,2012,139,8,147,0,
4765,35660,"Niles-Benton Harbor, MI Metro Area",Bus,2013,144,9,153,0,
4767,35660,"Niles-Benton Harbor, MI Metro Area",Bus,2014,113,9,122,0,
4769,35660,"Niles-Benton Harbor, MI Metro Area",Bus,2015,137,13,150,0,
4771,35660,"Niles-Benton Harbor, MI Metro Area",Bus,2016,127,26,153,0,
4773,35660,"Niles-Benton Harbor, MI Metro Area",Bus,2017,77,21,98,0,
4775,35660,"Niles-Benton Harbor, MI Metro Area",Bus,2018,86,111,197,0,
3468,35980,"Norwich-New London, CT Metro Area",Bus,2002,27,182,209,0,
3470,35980,"Norwich-New London, CT Metro Area",Bus,2003,38,149,187,0,
3472,35980,"Norwich-New London, CT Metro Area",Bus,2004,26,126,152,0,
3474,35980,"Norwich-New London, CT Metro Area",Bus,2005,22,127,149,0,
3476,35980,"Norwich-New London, CT Metro Area",Bus,2006,19,137,156,0,
3478,35980,"Norwich-New London, CT Metro Area",Bus,2007,23,118,141,0,
3480,35980,"Norwich-New London, CT Metro Area",Bus,2008,21,133,154,0,
3482,35980,"Norwich-New London, CT Metro Area",Bus,2009,119,134,253,0,
3484,35980,"Norwich-New London, CT Metro Area",Bus,2010,123,205,328,0,
3486,35980,"Norwich-New London, CT Metro Area",Bus,2011,0,0,0,1,
3488,35980,"Norwich-New London, CT Metro Area",Bus,2012,180,33,213,0,
3490,35980,"Norwich-New London, CT Metro Area",Bus,2013,338,50,388,0,
3492,35980,"Norwich-New London, CT Metro Area",Bus,2014,40,400,440,0,
3494,35980,"Norwich-New London, CT Metro Area",Bus,2015,122,488,610,0,
3496,35980,"Norwich-New London, CT Metro Area",Bus,2016,120,480,600,0,
3498,35980,"Norwich-New London, CT Metro Area",Bus,2017,156,625,781,0,
3500,35980,"Norwich-New London, CT Metro Area",Bus,2018,333,607,940,0,
3502,36100,"Ocala, FL Metro Area",Bus,2002,0,0,0,1,
3503,36100,"Ocala, FL Metro Area",Bus,2003,0,0,0,1,
3504,36100,"Ocala, FL Metro Area",Bus,2004,0,0,0,1,
3505,36100,"Ocala, FL Metro Area",Bus,2005,0,0,0,1,
3506,36100,"Ocala, FL Metro Area",Bus,2006,0,0,0,1,
3507,36100,"Ocala, FL Metro Area",Bus,2007,0,0,0,1,
3508,36100,"Ocala, FL Metro Area",Bus,2008,0,0,0,1,
3509,36100,"Ocala, FL Metro Area",Bus,2009,0,0,0,1,
3510,36100,"Ocala, FL Metro Area",Bus,2010,0,0,0,1,
3511,36100,"Ocala, FL Metro Area",Bus,2011,0,0,0,1,
3512,36100,"Ocala, FL Metro Area",Bus,2012,32,42,74,0,
3513,36100,"Ocala, FL Metro Area",Bus,2013,47,27,74,0,
3514,36100,"Ocala, FL Metro Area",Bus,2014,67,38,105,0,
3515,36100,"Ocala, FL Metro Area",Bus,2015,42,51,93,0,
3516,36100,"Ocala, FL Metro Area",Bus,2016,64,28,92,0,
3517,36100,"Ocala, FL Metro Area",Bus,2017,11,90,101,0,
3518,36100,"Ocala, FL Metro Area",Bus,2018,5,93,98,0,
3519,36420,"Oklahoma City, OK Metro Area",Bus,2002,440,252,692,0,
3520,36420,"Oklahoma City, OK Metro Area",Bus,2003,415,322,737,0,
3521,36420,"Oklahoma City, OK Metro Area",Bus,2004,357,313,670,0,
3522,36420,"Oklahoma City, OK Metro Area",Bus,2005,286,658,944,0,
3523,36420,"Oklahoma City, OK Metro Area",Bus,2006,377,1075,1452,0,
3524,36420,"Oklahoma City, OK Metro Area",Bus,2007,469,1830,2299,0,
3525,36420,"Oklahoma City, OK Metro Area",Bus,2008,358,1554,1912,0,
3526,36420,"Oklahoma City, OK Metro Area",Bus,2009,264,1248,1512,0,
3527,36420,"Oklahoma City, OK Metro Area",Bus,2010,138,668,806,0,
3528,36420,"Oklahoma City, OK Metro Area",Bus,2011,184,610,794,0,
3529,36420,"Oklahoma City, OK Metro Area",Bus,2012,206,306,512,0,
3530,36420,"Oklahoma City, OK Metro Area",Bus,2013,197,210,407,0,
3531,36420,"Oklahoma City, OK Metro Area",Bus,2014,179,143,322,0,
3532,36420,"Oklahoma City, OK Metro Area",Bus,2015,171,102,273,0,
3533,36420,"Oklahoma City, OK Metro Area",Bus,2016,156,47,203,0,
3534,36420,"Oklahoma City, OK Metro Area",Bus,2017,137,103,240,0,
3535,36420,"Oklahoma City, OK Metro Area",Bus,2018,102,90,192,0,
3536,36500,"Olympia, WA Metro Area",Bus,2002,210,257,467,0,
3537,36500,"Olympia, WA Metro Area",Bus,2003,253,216,469,0,
3538,36500,"Olympia, WA Metro Area",Bus,2004,226,385,611,0,
3539,36500,"Olympia, WA Metro Area",Bus,2005,268,404,672,0,
3540,36500,"Olympia, WA Metro Area",Bus,2006,246,373,619,0,
3541,36500,"Olympia, WA Metro Area",Bus,2007,229,298,527,0,
3542,36500,"Olympia, WA Metro Area",Bus,2008,315,278,593,0,
3543,36500,"Olympia, WA Metro Area",Bus,2009,265,175,440,0,
3544,36500,"Olympia, WA Metro Area",Bus,2010,266,160,426,0,
3545,36500,"Olympia, WA Metro Area",Bus,2011,237,213,450,0,
3546,36500,"Olympia, WA Metro Area",Bus,2012,231,367,598,0,
3547,36500,"Olympia, WA Metro Area",Bus,2013,193,228,421,0,
3548,36500,"Olympia, WA Metro Area",Bus,2014,108,148,256,0,
3549,36500,"Olympia, WA Metro Area",Bus,2015,103,30,133,0,
3550,36500,"Olympia, WA Metro Area",Bus,2016,123,28,151,0,
3551,36500,"Olympia, WA Metro Area",Bus,2017,91,74,165,0,
3552,36500,"Olympia, WA Metro Area",Bus,2018,54,66,120,0,
3553,36540,"Omaha-Council Bluffs, NE-IA Metro Area",Bus,2002,3,272,275,0,
3554,36540,"Omaha-Council Bluffs, NE-IA Metro Area",Bus,2003,5,441,446,0,
3555,36540,"Omaha-Council Bluffs, NE-IA Metro Area",Bus,2004,421,12,433,0,
3556,36540,"Omaha-Council Bluffs, NE-IA Metro Area",Bus,2005,487,57,544,0,
3557,36540,"Omaha-Council Bluffs, NE-IA Metro Area",Bus,2006,501,49,550,0,
3558,36540,"Omaha-Council Bluffs, NE-IA Metro Area",Bus,2007,417,174,591,0,
3559,36540,"Omaha-Council Bluffs, NE-IA Metro Area",Bus,2008,646,335,981,0,
3560,36540,"Omaha-Council Bluffs, NE-IA Metro Area",Bus,2009,1131,3598,4729,0,
3561,36540,"Omaha-Council Bluffs, NE-IA Metro Area",Bus,2010,338,1154,1492,0,
3562,36540,"Omaha-Council Bluffs, NE-IA Metro Area",Bus,2011,292,1035,1327,0,
3563,36540,"Omaha-Council Bluffs, NE-IA Metro Area",Bus,2012,277,646,923,0,
3564,36540,"Omaha-Council Bluffs, NE-IA Metro Area",Bus,2013,228,681,909,0,
3565,36540,"Omaha-Council Bluffs, NE-IA Metro Area",Bus,2014,524,2076,2600,0,
3566,36540,"Omaha-Council Bluffs, NE-IA Metro Area",Bus,2015,311,2601,2912,0,
3567,36540,"Omaha-Council Bluffs, NE-IA Metro Area",Bus,2016,224,2494,2718,0,
3568,36540,"Omaha-Council Bluffs, NE-IA Metro Area",Bus,2017,218,3127,3345,0,
3569,36540,"Omaha-Council Bluffs, NE-IA Metro Area",Bus,2018,141,2477,2618,0,
2771,36740,"Orlando-Kissimmee-Sanford, FL Metro Area",Bus,2002,0,0,0,0,
3570,36740,"Orlando-Kissimmee-Sanford, FL Metro Area",Bus,2002,236,640,876,0,
2772,36740,"Orlando-Kissimmee-Sanford, FL Metro Area",Bus,2003,0,0,0,0,
3571,36740,"Orlando-Kissimmee-Sanford, FL Metro Area",Bus,2003,201,621,822,0,
2773,36740,"Orlando-Kissimmee-Sanford, FL Metro Area",Bus,2004,0,0,0,0,
3572,36740,"Orlando-Kissimmee-Sanford, FL Metro Area",Bus,2004,119,952,1071,0,
2774,36740,"Orlando-Kissimmee-Sanford, FL Metro Area",Bus,2005,0,0,0,0,
3573,36740,"Orlando-Kissimmee-Sanford, FL Metro Area",Bus,2005,87,1189,1276,0,
2775,36740,"Orlando-Kissimmee-Sanford, FL Metro Area",Bus,2006,0,0,0,0,
3574,36740,"Orlando-Kissimmee-Sanford, FL Metro Area",Bus,2006,904,415,1319,0,
2776,36740,"Orlando-Kissimmee-Sanford, FL Metro Area",Bus,2007,0,0,0,0,
3575,36740,"Orlando-Kissimmee-Sanford, FL Metro Area",Bus,2007,322,1428,1750,0,
2777,36740,"Orlando-Kissimmee-Sanford, FL Metro Area",Bus,2008,17,0,17,0,
3576,36740,"Orlando-Kissimmee-Sanford, FL Metro Area",Bus,2008,1073,242,1315,0,
2778,36740,"Orlando-Kissimmee-Sanford, FL Metro Area",Bus,2009,21,4,25,0,
3577,36740,"Orlando-Kissimmee-Sanford, FL Metro Area",Bus,2009,1580,36,1616,0,
2779,36740,"Orlando-Kissimmee-Sanford, FL Metro Area",Bus,2010,19,60,79,0,
3578,36740,"Orlando-Kissimmee-Sanford, FL Metro Area",Bus,2010,1481,38,1519,0,
2780,36740,"Orlando-Kissimmee-Sanford, FL Metro Area",Bus,2011,51,23,74,0,
3579,36740,"Orlando-Kissimmee-Sanford, FL Metro Area",Bus,2011,1029,19,1048,0,
2781,36740,"Orlando-Kissimmee-Sanford, FL Metro Area",Bus,2012,63,20,83,0,
3580,36740,"Orlando-Kissimmee-Sanford, FL Metro Area",Bus,2012,958,14,972,0,
2782,36740,"Orlando-Kissimmee-Sanford, FL Metro Area",Bus,2013,113,342,455,0,
3581,36740,"Orlando-Kissimmee-Sanford, FL Metro Area",Bus,2013,1487,140,1627,0,
2783,36740,"Orlando-Kissimmee-Sanford, FL Metro Area",Bus,2014,191,217,408,0,
3582,36740,"Orlando-Kissimmee-Sanford, FL Metro Area",Bus,2014,1498,220,1718,0,
2784,36740,"Orlando-Kissimmee-Sanford, FL Metro Area",Bus,2015,79,39,118,0,
3583,36740,"Orlando-Kissimmee-Sanford, FL Metro Area",Bus,2015,999,228,1227,0,
2785,36740,"Orlando-Kissimmee-Sanford, FL Metro Area",Bus,2016,77,62,139,0,
3584,36740,"Orlando-Kissimmee-Sanford, FL Metro Area",Bus,2016,1221,167,1388,0,
2786,36740,"Orlando-Kissimmee-Sanford, FL Metro Area",Bus,2017,87,48,135,0,
3585,36740,"Orlando-Kissimmee-Sanford, FL Metro Area",Bus,2017,910,200,1110,0,
2787,36740,"Orlando-Kissimmee-Sanford, FL Metro Area",Bus,2018,76,46,122,0,
3586,36740,"Orlando-Kissimmee-Sanford, FL Metro Area",Bus,2018,820,323,1143,0,
3587,36740,"Orlando-Kissimmee-Sanford, FL Metro Area",Rail,2002,0,0,0,0,
3588,36740,"Orlando-Kissimmee-Sanford, FL Metro Area",Rail,2003,0,0,0,0,
3589,36740,"Orlando-Kissimmee-Sanford, FL Metro Area",Rail,2004,0,0,0,0,
3590,36740,"Orlando-Kissimmee-Sanford, FL Metro Area",Rail,2005,0,0,0,0,
3591,36740,"Orlando-Kissimmee-Sanford, FL Metro Area",Rail,2006,0,0,0,0,
3592,36740,"Orlando-Kissimmee-Sanford, FL Metro Area",Rail,2007,0,0,0,0,
3593,36740,"Orlando-Kissimmee-Sanford, FL Metro Area",Rail,2008,0,0,0,0,
3594,36740,"Orlando-Kissimmee-Sanford, FL Metro Area",Rail,2009,0,0,0,0,
3595,36740,"Orlando-Kissimmee-Sanford, FL Metro Area",Rail,2010,0,0,0,0,
3596,36740,"Orlando-Kissimmee-Sanford, FL Metro Area",Rail,2011,0,0,0,0,
3597,36740,"Orlando-Kissimmee-Sanford, FL Metro Area",Rail,2012,0,0,0,0,
3598,36740,"Orlando-Kissimmee-Sanford, FL Metro Area",Rail,2013,0,0,0,0,
3599,36740,"Orlando-Kissimmee-Sanford, FL Metro Area",Rail,2014,0,0,0,0,
3600,36740,"Orlando-Kissimmee-Sanford, FL Metro Area",Rail,2015,0,2,2,0,
3601,36740,"Orlando-Kissimmee-Sanford, FL Metro Area",Rail,2016,0,3,3,0,
3602,36740,"Orlando-Kissimmee-Sanford, FL Metro Area",Rail,2017,0,6,6,0,
3603,36740,"Orlando-Kissimmee-Sanford, FL Metro Area",Rail,2018,0,8,8,0,
205,36780,"Oshkosh-Neenah, WI Metro Area",Bus,2002,4,24,28,0,
3604,36780,"Oshkosh-Neenah, WI Metro Area",Bus,2002,6,3,9,0,
207,36780,"Oshkosh-Neenah, WI Metro Area",Bus,2003,29,101,130,0,
3605,36780,"Oshkosh-Neenah, WI Metro Area",Bus,2003,6,6,12,0,
209,36780,"Oshkosh-Neenah, WI Metro Area",Bus,2004,35,129,164,0,
3606,36780,"Oshkosh-Neenah, WI Metro Area",Bus,2004,3,1,4,0,
211,36780,"Oshkosh-Neenah, WI Metro Area",Bus,2005,33,101,134,0,
3607,36780,"Oshkosh-Neenah, WI Metro Area",Bus,2005,5,1,6,0,
213,36780,"Oshkosh-Neenah, WI Metro Area",Bus,2006,21,48,69,0,
3608,36780,"Oshkosh-Neenah, WI Metro Area",Bus,2006,26,52,78,0,
215,36780,"Oshkosh-Neenah, WI Metro Area",Bus,2007,29,78,107,0,
3609,36780,"Oshkosh-Neenah, WI Metro Area",Bus,2007,24,48,72,0,
217,36780,"Oshkosh-Neenah, WI Metro Area",Bus,2008,39,106,145,0,
3610,36780,"Oshkosh-Neenah, WI Metro Area",Bus,2008,13,30,43,0,
219,36780,"Oshkosh-Neenah, WI Metro Area",Bus,2009,33,81,114,0,
3611,36780,"Oshkosh-Neenah, WI Metro Area",Bus,2009,19,37,56,0,
221,36780,"Oshkosh-Neenah, WI Metro Area",Bus,2010,36,158,194,0,
3612,36780,"Oshkosh-Neenah, WI Metro Area",Bus,2010,20,26,46,0,
223,36780,"Oshkosh-Neenah, WI Metro Area",Bus,2011,33,162,195,0,
3613,36780,"Oshkosh-Neenah, WI Metro Area",Bus,2011,39,32,71,0,
225,36780,"Oshkosh-Neenah, WI Metro Area",Bus,2012,29,149,178,0,
3614,36780,"Oshkosh-Neenah, WI Metro Area",Bus,2012,34,29,63,0,
227,36780,"Oshkosh-Neenah, WI Metro Area",Bus,2013,26,148,174,0,
3615,36780,"Oshkosh-Neenah, WI Metro Area",Bus,2013,29,126,155,0,
229,36780,"Oshkosh-Neenah, WI Metro Area",Bus,2014,44,155,199,0,
3616,36780,"Oshkosh-Neenah, WI Metro Area",Bus,2014,53,76,129,0,
231,36780,"Oshkosh-Neenah, WI Metro Area",Bus,2015,29,93,122,0,
3617,36780,"Oshkosh-Neenah, WI Metro Area",Bus,2015,67,62,129,0,
233,36780,"Oshkosh-Neenah, WI Metro Area",Bus,2016,38,127,165,0,
3618,36780,"Oshkosh-Neenah, WI Metro Area",Bus,2016,58,73,131,0,
235,36780,"Oshkosh-Neenah, WI Metro Area",Bus,2017,44,138,182,0,
3619,36780,"Oshkosh-Neenah, WI Metro Area",Bus,2017,72,57,129,0,
237,36780,"Oshkosh-Neenah, WI Metro Area",Bus,2018,35,157,192,0,
3620,36780,"Oshkosh-Neenah, WI Metro Area",Bus,2018,38,46,84,0,
3621,37100,"Oxnard-Thousand Oaks-Ventura, CA Metro Area",Bus,2002,210,52,262,0,
3622,37100,"Oxnard-Thousand Oaks-Ventura, CA Metro Area",Bus,2003,198,31,229,0,
3623,37100,"Oxnard-Thousand Oaks-Ventura, CA Metro Area",Bus,2004,208,35,243,0,
3624,37100,"Oxnard-Thousand Oaks-Ventura, CA Metro Area",Bus,2005,235,44,279,0,
3625,37100,"Oxnard-Thousand Oaks-Ventura, CA Metro Area",Bus,2006,159,41,200,0,
3626,37100,"Oxnard-Thousand Oaks-Ventura, CA Metro Area",Bus,2007,172,26,198,0,
3627,37100,"Oxnard-Thousand Oaks-Ventura, CA Metro Area",Bus,2008,175,41,216,0,
3628,37100,"Oxnard-Thousand Oaks-Ventura, CA Metro Area",Bus,2009,275,49,324,0,
3629,37100,"Oxnard-Thousand Oaks-Ventura, CA Metro Area",Bus,2010,256,69,325,0,
3630,37100,"Oxnard-Thousand Oaks-Ventura, CA Metro Area",Bus,2011,174,80,254,0,
3631,37100,"Oxnard-Thousand Oaks-Ventura, CA Metro Area",Bus,2012,110,21,131,0,
3632,37100,"Oxnard-Thousand Oaks-Ventura, CA Metro Area",Bus,2013,111,30,141,0,
3633,37100,"Oxnard-Thousand Oaks-Ventura, CA Metro Area",Bus,2014,177,20,197,0,
3634,37100,"Oxnard-Thousand Oaks-Ventura, CA Metro Area",Bus,2015,169,27,196,0,
3635,37100,"Oxnard-Thousand Oaks-Ventura, CA Metro Area",Bus,2016,175,34,209,0,
3636,37100,"Oxnard-Thousand Oaks-Ventura, CA Metro Area",Bus,2017,159,23,182,0,
3637,37100,"Oxnard-Thousand Oaks-Ventura, CA Metro Area",Bus,2018,199,33,232,0,
3638,37340,"Palm Bay-Melbourne-Titusville, FL Metro Area",Bus,2002,7,29,36,0,
3639,37340,"Palm Bay-Melbourne-Titusville, FL Metro Area",Bus,2003,14,25,39,0,
3640,37340,"Palm Bay-Melbourne-Titusville, FL Metro Area",Bus,2004,10,7,17,0,
3641,37340,"Palm Bay-Melbourne-Titusville, FL Metro Area",Bus,2005,20,25,45,0,
3642,37340,"Palm Bay-Melbourne-Titusville, FL Metro Area",Bus,2006,16,27,43,0,
3643,37340,"Palm Bay-Melbourne-Titusville, FL Metro Area",Bus,2007,41,21,62,0,
3644,37340,"Palm Bay-Melbourne-Titusville, FL Metro Area",Bus,2008,42,43,85,0,
3645,37340,"Palm Bay-Melbourne-Titusville, FL Metro Area",Bus,2009,63,64,127,0,
3646,37340,"Palm Bay-Melbourne-Titusville, FL Metro Area",Bus,2010,81,60,141,0,
3647,37340,"Palm Bay-Melbourne-Titusville, FL Metro Area",Bus,2011,50,59,109,0,
3648,37340,"Palm Bay-Melbourne-Titusville, FL Metro Area",Bus,2012,16,83,99,0,
3649,37340,"Palm Bay-Melbourne-Titusville, FL Metro Area",Bus,2013,20,27,47,0,
3650,37340,"Palm Bay-Melbourne-Titusville, FL Metro Area",Bus,2014,20,27,47,0,
3651,37340,"Palm Bay-Melbourne-Titusville, FL Metro Area",Bus,2015,19,26,45,0,
3652,37340,"Palm Bay-Melbourne-Titusville, FL Metro Area",Bus,2016,17,23,40,0,
3653,37340,"Palm Bay-Melbourne-Titusville, FL Metro Area",Bus,2017,18,25,43,0,
3654,37340,"Palm Bay-Melbourne-Titusville, FL Metro Area",Bus,2018,21,29,50,0,
3656,37380,"Palm Coast, FL Metro Area",Bus,2002,15,2,17,0,
3658,37380,"Palm Coast, FL Metro Area",Bus,2003,26,3,29,0,
3660,37380,"Palm Coast, FL Metro Area",Bus,2004,173,122,295,0,
3662,37380,"Palm Coast, FL Metro Area",Bus,2005,271,77,348,0,
3664,37380,"Palm Coast, FL Metro Area",Bus,2006,427,116,543,0,
3666,37380,"Palm Coast, FL Metro Area",Bus,2007,417,245,662,0,
3668,37380,"Palm Coast, FL Metro Area",Bus,2008,419,167,586,0,
3670,37380,"Palm Coast, FL Metro Area",Bus,2009,453,207,660,0,
3672,37380,"Palm Coast, FL Metro Area",Bus,2010,296,424,720,0,
3674,37380,"Palm Coast, FL Metro Area",Bus,2011,370,182,552,0,
3676,37380,"Palm Coast, FL Metro Area",Bus,2012,383,126,509,0,
3678,37380,"Palm Coast, FL Metro Area",Bus,2013,469,93,562,0,
3680,37380,"Palm Coast, FL Metro Area",Bus,2014,179,400,579,0,
3682,37380,"Palm Coast, FL Metro Area",Bus,2015,175,428,603,0,
3684,37380,"Palm Coast, FL Metro Area",Bus,2016,302,181,483,0,
3686,37380,"Palm Coast, FL Metro Area",Bus,2017,329,90,419,0,
3688,37380,"Palm Coast, FL Metro Area",Bus,2018,398,130,528,0,
2007,37700,"Pascagoula, MS Metro Area",Bus,2002,101,80,181,0,
2009,37700,"Pascagoula, MS Metro Area",Bus,2003,156,191,347,0,
2011,37700,"Pascagoula, MS Metro Area",Bus,2004,128,145,273,0,
2013,37700,"Pascagoula, MS Metro Area",Bus,2005,120,199,319,0,
2015,37700,"Pascagoula, MS Metro Area",Bus,2006,104,77,181,0,
2017,37700,"Pascagoula, MS Metro Area",Bus,2007,96,84,180,0,
2019,37700,"Pascagoula, MS Metro Area",Bus,2008,69,109,178,0,
2021,37700,"Pascagoula, MS Metro Area",Bus,2009,107,154,261,0,
2023,37700,"Pascagoula, MS Metro Area",Bus,2010,119,310,429,0,
2025,37700,"Pascagoula, MS Metro Area",Bus,2011,122,313,435,0,
2027,37700,"Pascagoula, MS Metro Area",Bus,2012,142,398,540,0,
2029,37700,"Pascagoula, MS Metro Area",Bus,2013,230,458,688,0,
2031,37700,"Pascagoula, MS Metro Area",Bus,2014,241,374,615,0,
2033,37700,"Pascagoula, MS Metro Area",Bus,2015,225,356,581,0,
2035,37700,"Pascagoula, MS Metro Area",Bus,2016,211,137,348,0,
2037,37700,"Pascagoula, MS Metro Area",Bus,2017,151,210,361,0,
2039,37700,"Pascagoula, MS Metro Area",Bus,2018,128,242,370,0,
1803,37860,"Pensacola-Ferry Pass-Brent, FL Metro Area",Bus,2002,0,0,0,0,
3689,37860,"Pensacola-Ferry Pass-Brent, FL Metro Area",Bus,2002,45,4,49,0,
1805,37860,"Pensacola-Ferry Pass-Brent, FL Metro Area",Bus,2003,0,0,0,0,
3690,37860,"Pensacola-Ferry Pass-Brent, FL Metro Area",Bus,2003,77,14,91,0,
1807,37860,"Pensacola-Ferry Pass-Brent, FL Metro Area",Bus,2004,0,0,0,0,
3691,37860,"Pensacola-Ferry Pass-Brent, FL Metro Area",Bus,2004,86,0,86,0,
1809,37860,"Pensacola-Ferry Pass-Brent, FL Metro Area",Bus,2005,0,0,0,0,
3692,37860,"Pensacola-Ferry Pass-Brent, FL Metro Area",Bus,2005,125,0,125,0,
1811,37860,"Pensacola-Ferry Pass-Brent, FL Metro Area",Bus,2006,0,0,0,0,
3693,37860,"Pensacola-Ferry Pass-Brent, FL Metro Area",Bus,2006,191,12,203,0,
1813,37860,"Pensacola-Ferry Pass-Brent, FL Metro Area",Bus,2007,0,0,0,0,
3694,37860,"Pensacola-Ferry Pass-Brent, FL Metro Area",Bus,2007,196,38,234,0,
1815,37860,"Pensacola-Ferry Pass-Brent, FL Metro Area",Bus,2008,0,0,0,0,
3695,37860,"Pensacola-Ferry Pass-Brent, FL Metro Area",Bus,2008,122,32,154,0,
1817,37860,"Pensacola-Ferry Pass-Brent, FL Metro Area",Bus,2009,13,2,15,0,
3696,37860,"Pensacola-Ferry Pass-Brent, FL Metro Area",Bus,2009,120,22,142,0,
1819,37860,"Pensacola-Ferry Pass-Brent, FL Metro Area",Bus,2010,7,5,12,0,
3697,37860,"Pensacola-Ferry Pass-Brent, FL Metro Area",Bus,2010,134,14,148,0,
1821,37860,"Pensacola-Ferry Pass-Brent, FL Metro Area",Bus,2011,5,5,10,0,
3698,37860,"Pensacola-Ferry Pass-Brent, FL Metro Area",Bus,2011,139,29,168,0,
1823,37860,"Pensacola-Ferry Pass-Brent, FL Metro Area",Bus,2012,11,4,15,0,
3699,37860,"Pensacola-Ferry Pass-Brent, FL Metro Area",Bus,2012,101,34,135,0,
1825,37860,"Pensacola-Ferry Pass-Brent, FL Metro Area",Bus,2013,19,0,19,0,
3700,37860,"Pensacola-Ferry Pass-Brent, FL Metro Area",Bus,2013,23,79,102,0,
1827,37860,"Pensacola-Ferry Pass-Brent, FL Metro Area",Bus,2014,4,5,9,0,
3701,37860,"Pensacola-Ferry Pass-Brent, FL Metro Area",Bus,2014,44,105,149,0,
1829,37860,"Pensacola-Ferry Pass-Brent, FL Metro Area",Bus,2015,17,6,23,0,
3702,37860,"Pensacola-Ferry Pass-Brent, FL Metro Area",Bus,2015,55,41,96,0,
1831,37860,"Pensacola-Ferry Pass-Brent, FL Metro Area",Bus,2016,15,9,24,0,
3703,37860,"Pensacola-Ferry Pass-Brent, FL Metro Area",Bus,2016,80,9,89,0,
1833,37860,"Pensacola-Ferry Pass-Brent, FL Metro Area",Bus,2017,13,14,27,0,
3704,37860,"Pensacola-Ferry Pass-Brent, FL Metro Area",Bus,2017,84,9,93,0,
1835,37860,"Pensacola-Ferry Pass-Brent, FL Metro Area",Bus,2018,20,17,37,0,
3705,37860,"Pensacola-Ferry Pass-Brent, FL Metro Area",Bus,2018,38,112,150,0,
3706,37900,"Peoria, IL Metro Area",Bus,2002,126,434,560,0,
3707,37900,"Peoria, IL Metro Area",Bus,2003,174,325,499,0,
3708,37900,"Peoria, IL Metro Area",Bus,2004,112,311,423,0,
3709,37900,"Peoria, IL Metro Area",Bus,2005,136,332,468,0,
3710,37900,"Peoria, IL Metro Area",Bus,2006,132,546,678,0,
3711,37900,"Peoria, IL Metro Area",Bus,2007,294,482,776,0,
3712,37900,"Peoria, IL Metro Area",Bus,2008,272,577,849,0,
3713,37900,"Peoria, IL Metro Area",Bus,2009,588,493,1081,0,
3714,37900,"Peoria, IL Metro Area",Bus,2010,578,592,1170,0,
3715,37900,"Peoria, IL Metro Area",Bus,2011,543,678,1221,0,
3716,37900,"Peoria, IL Metro Area",Bus,2012,256,300,556,0,
3717,37900,"Peoria, IL Metro Area",Bus,2013,187,324,511,0,
3718,37900,"Peoria, IL Metro Area",Bus,2014,311,230,541,0,
3719,37900,"Peoria, IL Metro Area",Bus,2015,497,261,758,0,
3720,37900,"Peoria, IL Metro Area",Bus,2016,612,305,917,0,
3721,37900,"Peoria, IL Metro Area",Bus,2017,548,237,785,0,
3722,37900,"Peoria, IL Metro Area",Bus,2018,546,292,838,0,
3740,37980,"Philadelphia-Camden-Wilmington, PA-NJ-DE-MD Metro Area",Bus,2002,4608,2505,7113,0,
3961,37980,"Philadelphia-Camden-Wilmington, PA-NJ-DE-MD Metro Area",Bus,2002,0,0,0,0,
3741,37980,"Philadelphia-Camden-Wilmington, PA-NJ-DE-MD Metro Area",Bus,2003,4496,2571,7067,0,
3963,37980,"Philadelphia-Camden-Wilmington, PA-NJ-DE-MD Metro Area",Bus,2003,0,0,0,0,
3742,37980,"Philadelphia-Camden-Wilmington, PA-NJ-DE-MD Metro Area",Bus,2004,7767,3587,11354,0,
3965,37980,"Philadelphia-Camden-Wilmington, PA-NJ-DE-MD Metro Area",Bus,2004,0,0,0,0,
3743,37980,"Philadelphia-Camden-Wilmington, PA-NJ-DE-MD Metro Area",Bus,2005,6683,2999,9682,0,
3967,37980,"Philadelphia-Camden-Wilmington, PA-NJ-DE-MD Metro Area",Bus,2005,0,0,0,0,
3744,37980,"Philadelphia-Camden-Wilmington, PA-NJ-DE-MD Metro Area",Bus,2006,7897,3696,11593,0,
3969,37980,"Philadelphia-Camden-Wilmington, PA-NJ-DE-MD Metro Area",Bus,2006,0,0,0,0,
3745,37980,"Philadelphia-Camden-Wilmington, PA-NJ-DE-MD Metro Area",Bus,2007,7482,3702,11184,0,
3971,37980,"Philadelphia-Camden-Wilmington, PA-NJ-DE-MD Metro Area",Bus,2007,0,0,0,0,
3746,37980,"Philadelphia-Camden-Wilmington, PA-NJ-DE-MD Metro Area",Bus,2008,7607,3915,11522,0,
3973,37980,"Philadelphia-Camden-Wilmington, PA-NJ-DE-MD Metro Area",Bus,2008,0,0,0,0,
3747,37980,"Philadelphia-Camden-Wilmington, PA-NJ-DE-MD Metro Area",Bus,2009,7673,4318,11991,0,
3975,37980,"Philadelphia-Camden-Wilmington, PA-NJ-DE-MD Metro Area",Bus,2009,0,0,0,0,
3748,37980,"Philadelphia-Camden-Wilmington, PA-NJ-DE-MD Metro Area",Bus,2010,7548,3341,10889,0,
3977,37980,"Philadelphia-Camden-Wilmington, PA-NJ-DE-MD Metro Area",Bus,2010,0,0,0,0,
3749,37980,"Philadelphia-Camden-Wilmington, PA-NJ-DE-MD Metro Area",Bus,2011,7165,2981,10146,0,
3979,37980,"Philadelphia-Camden-Wilmington, PA-NJ-DE-MD Metro Area",Bus,2011,0,0,0,0,
3750,37980,"Philadelphia-Camden-Wilmington, PA-NJ-DE-MD Metro Area",Bus,2012,7183,2927,10110,0,
3981,37980,"Philadelphia-Camden-Wilmington, PA-NJ-DE-MD Metro Area",Bus,2012,2,1,3,0,
3751,37980,"Philadelphia-Camden-Wilmington, PA-NJ-DE-MD Metro Area",Bus,2013,7287,2816,10103,0,
3983,37980,"Philadelphia-Camden-Wilmington, PA-NJ-DE-MD Metro Area",Bus,2013,2,1,3,0,
3752,37980,"Philadelphia-Camden-Wilmington, PA-NJ-DE-MD Metro Area",Bus,2014,8229,3842,12071,0,
3985,37980,"Philadelphia-Camden-Wilmington, PA-NJ-DE-MD Metro Area",Bus,2014,2,5,7,0,
3753,37980,"Philadelphia-Camden-Wilmington, PA-NJ-DE-MD Metro Area",Bus,2015,7215,3533,10748,0,
3987,37980,"Philadelphia-Camden-Wilmington, PA-NJ-DE-MD Metro Area",Bus,2015,0,0,0,0,
3754,37980,"Philadelphia-Camden-Wilmington, PA-NJ-DE-MD Metro Area",Bus,2016,5981,2800,8781,0,
3989,37980,"Philadelphia-Camden-Wilmington, PA-NJ-DE-MD Metro Area",Bus,2016,4,3,7,0,
3755,37980,"Philadelphia-Camden-Wilmington, PA-NJ-DE-MD Metro Area",Bus,2017,6417,3200,9617,0,
3991,37980,"Philadelphia-Camden-Wilmington, PA-NJ-DE-MD Metro Area",Bus,2017,4,21,25,0,
3756,37980,"Philadelphia-Camden-Wilmington, PA-NJ-DE-MD Metro Area",Bus,2018,6340,2846,9186,0,
3993,37980,"Philadelphia-Camden-Wilmington, PA-NJ-DE-MD Metro Area",Bus,2018,4,95,99,0,
3757,37980,"Philadelphia-Camden-Wilmington, PA-NJ-DE-MD Metro Area",Rail,2002,3263,2084,5347,0,
3758,37980,"Philadelphia-Camden-Wilmington, PA-NJ-DE-MD Metro Area",Rail,2003,953,1232,2185,0,
3759,37980,"Philadelphia-Camden-Wilmington, PA-NJ-DE-MD Metro Area",Rail,2004,779,351,1130,0,
3760,37980,"Philadelphia-Camden-Wilmington, PA-NJ-DE-MD Metro Area",Rail,2005,898,1081,1979,0,
3761,37980,"Philadelphia-Camden-Wilmington, PA-NJ-DE-MD Metro Area",Rail,2006,353,1852,2205,0,
3762,37980,"Philadelphia-Camden-Wilmington, PA-NJ-DE-MD Metro Area",Rail,2007,327,2287,2614,0,
3763,37980,"Philadelphia-Camden-Wilmington, PA-NJ-DE-MD Metro Area",Rail,2008,313,1733,2046,0,
3764,37980,"Philadelphia-Camden-Wilmington, PA-NJ-DE-MD Metro Area",Rail,2009,391,2235,2626,0,
3765,37980,"Philadelphia-Camden-Wilmington, PA-NJ-DE-MD Metro Area",Rail,2010,215,4889,5104,0,
3766,37980,"Philadelphia-Camden-Wilmington, PA-NJ-DE-MD Metro Area",Rail,2011,295,4998,5293,0,
3767,37980,"Philadelphia-Camden-Wilmington, PA-NJ-DE-MD Metro Area",Rail,2012,277,4080,4357,0,
3768,37980,"Philadelphia-Camden-Wilmington, PA-NJ-DE-MD Metro Area",Rail,2013,377,4586,4963,0,
3769,37980,"Philadelphia-Camden-Wilmington, PA-NJ-DE-MD Metro Area",Rail,2014,365,4570,4935,0,
3770,37980,"Philadelphia-Camden-Wilmington, PA-NJ-DE-MD Metro Area",Rail,2015,378,4813,5191,0,
3771,37980,"Philadelphia-Camden-Wilmington, PA-NJ-DE-MD Metro Area",Rail,2016,317,4114,4431,0,
3772,37980,"Philadelphia-Camden-Wilmington, PA-NJ-DE-MD Metro Area",Rail,2017,431,3500,3931,0,
3773,37980,"Philadelphia-Camden-Wilmington, PA-NJ-DE-MD Metro Area",Rail,2018,412,3678,4090,0,
3774,38060,"Phoenix-Mesa-Glendale, AZ Metro Area",Bus,2002,887,2,889,0,
3775,38060,"Phoenix-Mesa-Glendale, AZ Metro Area",Bus,2003,2,4,6,1,
3776,38060,"Phoenix-Mesa-Glendale, AZ Metro Area",Bus,2004,3,2,5,1,
3777,38060,"Phoenix-Mesa-Glendale, AZ Metro Area",Bus,2005,3,5,8,1,
3778,38060,"Phoenix-Mesa-Glendale, AZ Metro Area",Bus,2006,5,6,11,1,
3779,38060,"Phoenix-Mesa-Glendale, AZ Metro Area",Bus,2007,2,12,14,1,
3780,38060,"Phoenix-Mesa-Glendale, AZ Metro Area",Bus,2008,4,3,7,1,
3781,38060,"Phoenix-Mesa-Glendale, AZ Metro Area",Bus,2009,2438,325,2763,0,
3782,38060,"Phoenix-Mesa-Glendale, AZ Metro Area",Bus,2010,2200,231,2431,0,
3783,38060,"Phoenix-Mesa-Glendale, AZ Metro Area",Bus,2011,2075,388,2463,0,
3784,38060,"Phoenix-Mesa-Glendale, AZ Metro Area",Bus,2012,2417,445,2862,0,
3785,38060,"Phoenix-Mesa-Glendale, AZ Metro Area",Bus,2013,3826,979,4805,0,
3786,38060,"Phoenix-Mesa-Glendale, AZ Metro Area",Bus,2014,4641,2201,6842,0,
3787,38060,"Phoenix-Mesa-Glendale, AZ Metro Area",Bus,2015,3627,1366,4993,0,
3788,38060,"Phoenix-Mesa-Glendale, AZ Metro Area",Bus,2016,4288,1284,5572,0,
3789,38060,"Phoenix-Mesa-Glendale, AZ Metro Area",Bus,2017,5048,2207,7255,0,
3790,38060,"Phoenix-Mesa-Glendale, AZ Metro Area",Bus,2018,3971,1193,5164,0,
3791,38060,"Phoenix-Mesa-Glendale, AZ Metro Area",Rail,2002,0,0,0,1,
3792,38060,"Phoenix-Mesa-Glendale, AZ Metro Area",Rail,2003,0,0,0,1,
3793,38060,"Phoenix-Mesa-Glendale, AZ Metro Area",Rail,2004,0,0,0,1,
3794,38060,"Phoenix-Mesa-Glendale, AZ Metro Area",Rail,2005,0,0,0,1,
3795,38060,"Phoenix-Mesa-Glendale, AZ Metro Area",Rail,2006,0,0,0,1,
3796,38060,"Phoenix-Mesa-Glendale, AZ Metro Area",Rail,2007,0,0,0,1,
3797,38060,"Phoenix-Mesa-Glendale, AZ Metro Area",Rail,2008,0,0,0,1,
3798,38060,"Phoenix-Mesa-Glendale, AZ Metro Area",Rail,2009,134,45,179,1,
3799,38060,"Phoenix-Mesa-Glendale, AZ Metro Area",Rail,2010,226,128,354,0,
3800,38060,"Phoenix-Mesa-Glendale, AZ Metro Area",Rail,2011,117,125,242,0,
3801,38060,"Phoenix-Mesa-Glendale, AZ Metro Area",Rail,2012,85,148,233,0,
3802,38060,"Phoenix-Mesa-Glendale, AZ Metro Area",Rail,2013,82,193,275,0,
3803,38060,"Phoenix-Mesa-Glendale, AZ Metro Area",Rail,2014,67,188,255,0,
3804,38060,"Phoenix-Mesa-Glendale, AZ Metro Area",Rail,2015,71,186,257,0,
3805,38060,"Phoenix-Mesa-Glendale, AZ Metro Area",Rail,2016,75,153,228,0,
3806,38060,"Phoenix-Mesa-Glendale, AZ Metro Area",Rail,2017,77,217,294,0,
3807,38060,"Phoenix-Mesa-Glendale, AZ Metro Area",Rail,2018,55,160,215,0,
3196,38300,"Pittsburgh, PA Metro Area",Bus,2002,0,0,0,0,
3808,38300,"Pittsburgh, PA Metro Area",Bus,2002,10876,27815,38691,1,
5202,38300,"Pittsburgh, PA Metro Area",Bus,2002,0,0,0,0,
3197,38300,"Pittsburgh, PA Metro Area",Bus,2003,0,0,0,0,
3809,38300,"Pittsburgh, PA Metro Area",Bus,2003,11845,23334,35179,1,
5203,38300,"Pittsburgh, PA Metro Area",Bus,2003,4,13,17,0,
3198,38300,"Pittsburgh, PA Metro Area",Bus,2004,0,0,0,0,
3810,38300,"Pittsburgh, PA Metro Area",Bus,2004,4590,1625,6215,0,
5204,38300,"Pittsburgh, PA Metro Area",Bus,2004,0,0,0,0,
3199,38300,"Pittsburgh, PA Metro Area",Bus,2005,0,0,0,0,
3811,38300,"Pittsburgh, PA Metro Area",Bus,2005,6940,1155,8095,0,
5205,38300,"Pittsburgh, PA Metro Area",Bus,2005,0,0,0,0,
3200,38300,"Pittsburgh, PA Metro Area",Bus,2006,0,0,0,0,
3812,38300,"Pittsburgh, PA Metro Area",Bus,2006,4374,422,4796,0,
5206,38300,"Pittsburgh, PA Metro Area",Bus,2006,0,0,0,0,
3201,38300,"Pittsburgh, PA Metro Area",Bus,2007,0,0,0,0,
3813,38300,"Pittsburgh, PA Metro Area",Bus,2007,3864,653,4517,0,
5207,38300,"Pittsburgh, PA Metro Area",Bus,2007,15,62,77,0,
3202,38300,"Pittsburgh, PA Metro Area",Bus,2008,30,8,38,0,
3814,38300,"Pittsburgh, PA Metro Area",Bus,2008,3503,444,3947,0,
5208,38300,"Pittsburgh, PA Metro Area",Bus,2008,66,164,230,0,
3203,38300,"Pittsburgh, PA Metro Area",Bus,2009,4,80,84,0,
3815,38300,"Pittsburgh, PA Metro Area",Bus,2009,4319,144,4463,0,
5209,38300,"Pittsburgh, PA Metro Area",Bus,2009,81,188,269,0,
3204,38300,"Pittsburgh, PA Metro Area",Bus,2010,3,36,39,0,
3816,38300,"Pittsburgh, PA Metro Area",Bus,2010,4035,181,4216,0,
5210,38300,"Pittsburgh, PA Metro Area",Bus,2010,33,185,218,0,
3205,38300,"Pittsburgh, PA Metro Area",Bus,2011,31,74,105,0,
3817,38300,"Pittsburgh, PA Metro Area",Bus,2011,4230,240,4470,0,
5211,38300,"Pittsburgh, PA Metro Area",Bus,2011,21,65,86,0,
3206,38300,"Pittsburgh, PA Metro Area",Bus,2012,129,136,265,0,
3818,38300,"Pittsburgh, PA Metro Area",Bus,2012,3509,318,3827,0,
5212,38300,"Pittsburgh, PA Metro Area",Bus,2012,23,65,88,0,
3207,38300,"Pittsburgh, PA Metro Area",Bus,2013,107,222,329,0,
3819,38300,"Pittsburgh, PA Metro Area",Bus,2013,2843,380,3223,0,
5213,38300,"Pittsburgh, PA Metro Area",Bus,2013,14,30,44,0,
3208,38300,"Pittsburgh, PA Metro Area",Bus,2014,54,27,81,0,
3820,38300,"Pittsburgh, PA Metro Area",Bus,2014,2795,344,3139,0,
5214,38300,"Pittsburgh, PA Metro Area",Bus,2014,29,31,60,0,
3209,38300,"Pittsburgh, PA Metro Area",Bus,2015,21,20,41,0,
3821,38300,"Pittsburgh, PA Metro Area",Bus,2015,2781,411,3192,0,
5215,38300,"Pittsburgh, PA Metro Area",Bus,2015,26,49,75,0,
3210,38300,"Pittsburgh, PA Metro Area",Bus,2016,23,45,68,0,
3822,38300,"Pittsburgh, PA Metro Area",Bus,2016,2310,395,2705,0,
5216,38300,"Pittsburgh, PA Metro Area",Bus,2016,41,64,105,0,
3211,38300,"Pittsburgh, PA Metro Area",Bus,2017,60,33,93,0,
3823,38300,"Pittsburgh, PA Metro Area",Bus,2017,1702,427,2129,0,
5217,38300,"Pittsburgh, PA Metro Area",Bus,2017,22,44,66,0,
3212,38300,"Pittsburgh, PA Metro Area",Bus,2018,64,51,115,0,
3824,38300,"Pittsburgh, PA Metro Area",Bus,2018,1629,561,2190,0,
5218,38300,"Pittsburgh, PA Metro Area",Bus,2018,11,35,46,0,
3825,38300,"Pittsburgh, PA Metro Area",Rail,2002,122,65,187,0,
3826,38300,"Pittsburgh, PA Metro Area",Rail,2003,124,14,138,0,
3827,38300,"Pittsburgh, PA Metro Area",Rail,2004,350,116,466,0,
3828,38300,"Pittsburgh, PA Metro Area",Rail,2005,146,108,254,0,
3829,38300,"Pittsburgh, PA Metro Area",Rail,2006,104,134,238,0,
3830,38300,"Pittsburgh, PA Metro Area",Rail,2007,105,107,212,0,
3831,38300,"Pittsburgh, PA Metro Area",Rail,2008,212,80,292,0,
3832,38300,"Pittsburgh, PA Metro Area",Rail,2009,197,141,338,0,
3833,38300,"Pittsburgh, PA Metro Area",Rail,2010,144,190,334,0,
3834,38300,"Pittsburgh, PA Metro Area",Rail,2011,208,282,490,0,
3835,38300,"Pittsburgh, PA Metro Area",Rail,2012,194,281,475,0,
3836,38300,"Pittsburgh, PA Metro Area",Rail,2013,162,309,471,0,
3837,38300,"Pittsburgh, PA Metro Area",Rail,2014,172,334,506,0,
3838,38300,"Pittsburgh, PA Metro Area",Rail,2015,187,162,349,0,
3839,38300,"Pittsburgh, PA Metro Area",Rail,2016,243,184,427,0,
3840,38300,"Pittsburgh, PA Metro Area",Rail,2017,220,87,307,0,
3841,38300,"Pittsburgh, PA Metro Area",Rail,2018,218,102,320,0,
3842,38340,"Pittsfield, MA Metro Area",Bus,2002,0,0,0,1,
3843,38340,"Pittsfield, MA Metro Area",Bus,2003,0,0,0,1,
3844,38340,"Pittsfield, MA Metro Area",Bus,2004,0,0,0,1,
3845,38340,"Pittsfield, MA Metro Area",Bus,2005,0,0,0,1,
3846,38340,"Pittsfield, MA Metro Area",Bus,2006,0,0,0,1,
3847,38340,"Pittsfield, MA Metro Area",Bus,2007,0,0,0,1,
3848,38340,"Pittsfield, MA Metro Area",Bus,2008,0,178,178,0,
3849,38340,"Pittsfield, MA Metro Area",Bus,2009,192,0,192,0,
3850,38340,"Pittsfield, MA Metro Area",Bus,2010,148,53,201,0,
3851,38340,"Pittsfield, MA Metro Area",Bus,2011,172,144,316,0,
3852,38340,"Pittsfield, MA Metro Area",Bus,2012,106,148,254,0,
3853,38340,"Pittsfield, MA Metro Area",Bus,2013,74,139,213,0,
3854,38340,"Pittsfield, MA Metro Area",Bus,2014,48,105,153,0,
3855,38340,"Pittsfield, MA Metro Area",Bus,2015,52,97,149,0,
3856,38340,"Pittsfield, MA Metro Area",Bus,2016,79,156,235,0,
3857,38340,"Pittsfield, MA Metro Area",Bus,2017,8,31,39,0,
3858,38340,"Pittsfield, MA Metro Area",Bus,2018,13,20,33,0,
3893,38860,"Portland-South Portland-Biddeford, ME Metro Area",Bus,2002,178,538,716,0,
3894,38860,"Portland-South Portland-Biddeford, ME Metro Area",Bus,2003,236,378,614,0,
3895,38860,"Portland-South Portland-Biddeford, ME Metro Area",Bus,2004,349,241,590,0,
3896,38860,"Portland-South Portland-Biddeford, ME Metro Area",Bus,2005,333,192,525,0,
3897,38860,"Portland-South Portland-Biddeford, ME Metro Area",Bus,2006,277,247,524,0,
3898,38860,"Portland-South Portland-Biddeford, ME Metro Area",Bus,2007,250,121,371,0,
3899,38860,"Portland-South Portland-Biddeford, ME Metro Area",Bus,2008,205,115,320,0,
3900,38860,"Portland-South Portland-Biddeford, ME Metro Area",Bus,2009,181,140,321,0,
3901,38860,"Portland-South Portland-Biddeford, ME Metro Area",Bus,2010,184,224,408,0,
3902,38860,"Portland-South Portland-Biddeford, ME Metro Area",Bus,2011,110,289,399,0,
3903,38860,"Portland-South Portland-Biddeford, ME Metro Area",Bus,2012,101,323,424,0,
3904,38860,"Portland-South Portland-Biddeford, ME Metro Area",Bus,2013,101,204,305,0,
3905,38860,"Portland-South Portland-Biddeford, ME Metro Area",Bus,2014,101,297,398,0,
3906,38860,"Portland-South Portland-Biddeford, ME Metro Area",Bus,2015,71,322,393,0,
3907,38860,"Portland-South Portland-Biddeford, ME Metro Area",Bus,2016,77,404,481,0,
3908,38860,"Portland-South Portland-Biddeford, ME Metro Area",Bus,2017,54,434,488,0,
3909,38860,"Portland-South Portland-Biddeford, ME Metro Area",Bus,2018,94,453,547,0,
3910,38860,"Portland-South Portland-Biddeford, ME Metro Area",Rail,2002,0,0,0,0,
3911,38860,"Portland-South Portland-Biddeford, ME Metro Area",Rail,2003,0,0,0,0,
3912,38860,"Portland-South Portland-Biddeford, ME Metro Area",Rail,2004,0,0,0,0,
3913,38860,"Portland-South Portland-Biddeford, ME Metro Area",Rail,2005,0,0,0,0,
3914,38860,"Portland-South Portland-Biddeford, ME Metro Area",Rail,2006,0,0,0,0,
3915,38860,"Portland-South Portland-Biddeford, ME Metro Area",Rail,2007,0,0,0,0,
3916,38860,"Portland-South Portland-Biddeford, ME Metro Area",Rail,2008,0,0,0,0,
3917,38860,"Portland-South Portland-Biddeford, ME Metro Area",Rail,2009,0,0,0,0,
3918,38860,"Portland-South Portland-Biddeford, ME Metro Area",Rail,2010,2,0,2,0,
3919,38860,"Portland-South Portland-Biddeford, ME Metro Area",Rail,2011,5,0,5,0,
3920,38860,"Portland-South Portland-Biddeford, ME Metro Area",Rail,2012,1,0,1,0,
3921,38860,"Portland-South Portland-Biddeford, ME Metro Area",Rail,2013,0,0,0,0,
3922,38860,"Portland-South Portland-Biddeford, ME Metro Area",Rail,2014,1,0,1,0,
3923,38860,"Portland-South Portland-Biddeford, ME Metro Area",Rail,2015,0,4,4,0,
3924,38860,"Portland-South Portland-Biddeford, ME Metro Area",Rail,2016,0,1,1,0,
3925,38860,"Portland-South Portland-Biddeford, ME Metro Area",Rail,2017,0,2,2,0,
3926,38860,"Portland-South Portland-Biddeford, ME Metro Area",Rail,2018,0,1,1,0,
3927,38900,"Portland-Vancouver-Hillsboro, OR-WA Metro Area",Bus,2002,2885,1195,4080,0,
3928,38900,"Portland-Vancouver-Hillsboro, OR-WA Metro Area",Bus,2003,3436,866,4302,0,
3929,38900,"Portland-Vancouver-Hillsboro, OR-WA Metro Area",Bus,2004,2837,658,3495,0,
3930,38900,"Portland-Vancouver-Hillsboro, OR-WA Metro Area",Bus,2005,2292,285,2577,0,
3931,38900,"Portland-Vancouver-Hillsboro, OR-WA Metro Area",Bus,2006,2227,178,2405,0,
3932,38900,"Portland-Vancouver-Hillsboro, OR-WA Metro Area",Bus,2007,1908,146,2054,0,
3933,38900,"Portland-Vancouver-Hillsboro, OR-WA Metro Area",Bus,2008,1772,177,1949,0,
3934,38900,"Portland-Vancouver-Hillsboro, OR-WA Metro Area",Bus,2009,1551,145,1696,0,
3935,38900,"Portland-Vancouver-Hillsboro, OR-WA Metro Area",Bus,2010,6779,2352,9131,0,
3936,38900,"Portland-Vancouver-Hillsboro, OR-WA Metro Area",Bus,2011,3661,3207,6868,0,
3937,38900,"Portland-Vancouver-Hillsboro, OR-WA Metro Area",Bus,2012,2742,4506,7248,0,
3938,38900,"Portland-Vancouver-Hillsboro, OR-WA Metro Area",Bus,2013,2351,4308,6659,0,
3939,38900,"Portland-Vancouver-Hillsboro, OR-WA Metro Area",Bus,2014,1622,4510,6132,0,
3940,38900,"Portland-Vancouver-Hillsboro, OR-WA Metro Area",Bus,2015,1658,4681,6339,0,
3941,38900,"Portland-Vancouver-Hillsboro, OR-WA Metro Area",Bus,2016,1382,4536,5918,0,
3942,38900,"Portland-Vancouver-Hillsboro, OR-WA Metro Area",Bus,2017,1601,6162,7763,0,
3943,38900,"Portland-Vancouver-Hillsboro, OR-WA Metro Area",Bus,2018,1513,3805,5318,0,
3944,38900,"Portland-Vancouver-Hillsboro, OR-WA Metro Area",Rail,2002,389,55,444,0,
3945,38900,"Portland-Vancouver-Hillsboro, OR-WA Metro Area",Rail,2003,310,114,424,0,
3946,38900,"Portland-Vancouver-Hillsboro, OR-WA Metro Area",Rail,2004,279,113,392,0,
3947,38900,"Portland-Vancouver-Hillsboro, OR-WA Metro Area",Rail,2005,284,100,384,0,
3948,38900,"Portland-Vancouver-Hillsboro, OR-WA Metro Area",Rail,2006,189,84,273,0,
3949,38900,"Portland-Vancouver-Hillsboro, OR-WA Metro Area",Rail,2007,223,76,299,0,
3950,38900,"Portland-Vancouver-Hillsboro, OR-WA Metro Area",Rail,2008,224,48,272,0,
3951,38900,"Portland-Vancouver-Hillsboro, OR-WA Metro Area",Rail,2009,342,55,397,0,
3952,38900,"Portland-Vancouver-Hillsboro, OR-WA Metro Area",Rail,2010,360,64,424,0,
3953,38900,"Portland-Vancouver-Hillsboro, OR-WA Metro Area",Rail,2011,361,116,477,0,
3954,38900,"Portland-Vancouver-Hillsboro, OR-WA Metro Area",Rail,2012,305,93,398,0,
3955,38900,"Portland-Vancouver-Hillsboro, OR-WA Metro Area",Rail,2013,265,101,366,0,
3956,38900,"Portland-Vancouver-Hillsboro, OR-WA Metro Area",Rail,2014,360,76,436,0,
3957,38900,"Portland-Vancouver-Hillsboro, OR-WA Metro Area",Rail,2015,296,179,475,0,
3958,38900,"Portland-Vancouver-Hillsboro, OR-WA Metro Area",Rail,2016,382,184,566,0,
3959,38900,"Portland-Vancouver-Hillsboro, OR-WA Metro Area",Rail,2017,390,226,616,0,
3960,38900,"Portland-Vancouver-Hillsboro, OR-WA Metro Area",Rail,2018,409,108,517,0,
3876,38940,"Port St. Lucie, FL Metro Area",Bus,2002,0,0,0,0,
3877,38940,"Port St. Lucie, FL Metro Area",Bus,2003,1,0,1,0,
3878,38940,"Port St. Lucie, FL Metro Area",Bus,2004,14,0,14,0,
3879,38940,"Port St. Lucie, FL Metro Area",Bus,2005,14,0,14,0,
3880,38940,"Port St. Lucie, FL Metro Area",Bus,2006,16,3,19,0,
3881,38940,"Port St. Lucie, FL Metro Area",Bus,2007,13,2,15,0,
3882,38940,"Port St. Lucie, FL Metro Area",Bus,2008,22,5,27,0,
3883,38940,"Port St. Lucie, FL Metro Area",Bus,2009,34,1,35,0,
3884,38940,"Port St. Lucie, FL Metro Area",Bus,2010,34,1,35,0,
3885,38940,"Port St. Lucie, FL Metro Area",Bus,2011,18,0,18,0,
3886,38940,"Port St. Lucie, FL Metro Area",Bus,2012,34,0,34,0,
3887,38940,"Port St. Lucie, FL Metro Area",Bus,2013,8,0,8,0,
3888,38940,"Port St. Lucie, FL Metro Area",Bus,2014,7,0,7,0,
3889,38940,"Port St. Lucie, FL Metro Area",Bus,2015,5,0,5,0,
3890,38940,"Port St. Lucie, FL Metro Area",Bus,2016,5,0,5,0,
3891,38940,"Port St. Lucie, FL Metro Area",Bus,2017,12,0,12,0,
3892,38940,"Port St. Lucie, FL Metro Area",Bus,2018,22,0,22,0,
3995,39100,"Poughkeepsie-Newburgh-Middletown, NY Metro Area",Bus,2002,72,114,186,0,
3996,39100,"Poughkeepsie-Newburgh-Middletown, NY Metro Area",Bus,2003,80,116,196,0,
3997,39100,"Poughkeepsie-Newburgh-Middletown, NY Metro Area",Bus,2004,64,119,183,0,
3998,39100,"Poughkeepsie-Newburgh-Middletown, NY Metro Area",Bus,2005,82,181,263,0,
3999,39100,"Poughkeepsie-Newburgh-Middletown, NY Metro Area",Bus,2006,98,155,253,0,
4000,39100,"Poughkeepsie-Newburgh-Middletown, NY Metro Area",Bus,2007,102,61,163,0,
4001,39100,"Poughkeepsie-Newburgh-Middletown, NY Metro Area",Bus,2008,94,61,155,0,
4002,39100,"Poughkeepsie-Newburgh-Middletown, NY Metro Area",Bus,2009,124,58,182,0,
4003,39100,"Poughkeepsie-Newburgh-Middletown, NY Metro Area",Bus,2010,141,109,250,0,
4004,39100,"Poughkeepsie-Newburgh-Middletown, NY Metro Area",Bus,2011,92,116,208,0,
4005,39100,"Poughkeepsie-Newburgh-Middletown, NY Metro Area",Bus,2012,81,109,190,0,
4006,39100,"Poughkeepsie-Newburgh-Middletown, NY Metro Area",Bus,2013,125,93,218,0,
4007,39100,"Poughkeepsie-Newburgh-Middletown, NY Metro Area",Bus,2014,114,102,216,0,
4008,39100,"Poughkeepsie-Newburgh-Middletown, NY Metro Area",Bus,2015,120,97,217,0,
4009,39100,"Poughkeepsie-Newburgh-Middletown, NY Metro Area",Bus,2016,123,111,234,0,
4010,39100,"Poughkeepsie-Newburgh-Middletown, NY Metro Area",Bus,2017,111,77,188,0,
4011,39100,"Poughkeepsie-Newburgh-Middletown, NY Metro Area",Bus,2018,172,83,255,0,
3366,39300,"Providence-New Bedford-Fall River, RI-MA Metro Area",Bus,2002,0,0,0,0,
3469,39300,"Providence-New Bedford-Fall River, RI-MA Metro Area",Bus,2002,27,182,209,0,
4012,39300,"Providence-New Bedford-Fall River, RI-MA Metro Area",Bus,2002,1714,1745,3459,0,
3367,39300,"Providence-New Bedford-Fall River, RI-MA Metro Area",Bus,2003,0,0,0,0,
3471,39300,"Providence-New Bedford-Fall River, RI-MA Metro Area",Bus,2003,38,149,187,0,
4013,39300,"Providence-New Bedford-Fall River, RI-MA Metro Area",Bus,2003,1450,1718,3168,0,
3368,39300,"Providence-New Bedford-Fall River, RI-MA Metro Area",Bus,2004,0,0,0,0,
3473,39300,"Providence-New Bedford-Fall River, RI-MA Metro Area",Bus,2004,26,126,152,0,
4014,39300,"Providence-New Bedford-Fall River, RI-MA Metro Area",Bus,2004,1542,1710,3252,0,
3369,39300,"Providence-New Bedford-Fall River, RI-MA Metro Area",Bus,2005,0,0,0,0,
3475,39300,"Providence-New Bedford-Fall River, RI-MA Metro Area",Bus,2005,22,127,149,0,
4015,39300,"Providence-New Bedford-Fall River, RI-MA Metro Area",Bus,2005,943,1930,2873,0,
3370,39300,"Providence-New Bedford-Fall River, RI-MA Metro Area",Bus,2006,0,0,0,0,
3477,39300,"Providence-New Bedford-Fall River, RI-MA Metro Area",Bus,2006,19,137,156,0,
4016,39300,"Providence-New Bedford-Fall River, RI-MA Metro Area",Bus,2006,1077,1897,2974,0,
3371,39300,"Providence-New Bedford-Fall River, RI-MA Metro Area",Bus,2007,0,0,0,0,
3479,39300,"Providence-New Bedford-Fall River, RI-MA Metro Area",Bus,2007,23,118,141,0,
4017,39300,"Providence-New Bedford-Fall River, RI-MA Metro Area",Bus,2007,1090,1743,2833,0,
3372,39300,"Providence-New Bedford-Fall River, RI-MA Metro Area",Bus,2008,2,12,14,0,
3481,39300,"Providence-New Bedford-Fall River, RI-MA Metro Area",Bus,2008,21,133,154,0,
4018,39300,"Providence-New Bedford-Fall River, RI-MA Metro Area",Bus,2008,1272,2024,3296,0,
3373,39300,"Providence-New Bedford-Fall River, RI-MA Metro Area",Bus,2009,14,623,637,0,
3483,39300,"Providence-New Bedford-Fall River, RI-MA Metro Area",Bus,2009,119,134,253,0,
4019,39300,"Providence-New Bedford-Fall River, RI-MA Metro Area",Bus,2009,1231,1679,2910,0,
3374,39300,"Providence-New Bedford-Fall River, RI-MA Metro Area",Bus,2010,52,799,851,0,
3485,39300,"Providence-New Bedford-Fall River, RI-MA Metro Area",Bus,2010,123,205,328,0,
4020,39300,"Providence-New Bedford-Fall River, RI-MA Metro Area",Bus,2010,1159,2068,3227,0,
3375,39300,"Providence-New Bedford-Fall River, RI-MA Metro Area",Bus,2011,66,556,622,0,
3487,39300,"Providence-New Bedford-Fall River, RI-MA Metro Area",Bus,2011,0,0,0,0,
4021,39300,"Providence-New Bedford-Fall River, RI-MA Metro Area",Bus,2011,726,1390,2116,0,
3376,39300,"Providence-New Bedford-Fall River, RI-MA Metro Area",Bus,2012,5,314,319,0,
3489,39300,"Providence-New Bedford-Fall River, RI-MA Metro Area",Bus,2012,180,33,213,0,
4022,39300,"Providence-New Bedford-Fall River, RI-MA Metro Area",Bus,2012,658,1156,1814,0,
3377,39300,"Providence-New Bedford-Fall River, RI-MA Metro Area",Bus,2013,15,288,303,0,
3491,39300,"Providence-New Bedford-Fall River, RI-MA Metro Area",Bus,2013,338,50,388,0,
4023,39300,"Providence-New Bedford-Fall River, RI-MA Metro Area",Bus,2013,481,914,1395,0,
3378,39300,"Providence-New Bedford-Fall River, RI-MA Metro Area",Bus,2014,2,134,136,0,
3493,39300,"Providence-New Bedford-Fall River, RI-MA Metro Area",Bus,2014,40,400,440,0,
4024,39300,"Providence-New Bedford-Fall River, RI-MA Metro Area",Bus,2014,535,1243,1778,0,
3379,39300,"Providence-New Bedford-Fall River, RI-MA Metro Area",Bus,2015,164,67,231,0,
3495,39300,"Providence-New Bedford-Fall River, RI-MA Metro Area",Bus,2015,122,488,610,0,
4025,39300,"Providence-New Bedford-Fall River, RI-MA Metro Area",Bus,2015,600,1155,1755,0,
3380,39300,"Providence-New Bedford-Fall River, RI-MA Metro Area",Bus,2016,29,335,364,0,
3497,39300,"Providence-New Bedford-Fall River, RI-MA Metro Area",Bus,2016,120,480,600,0,
4026,39300,"Providence-New Bedford-Fall River, RI-MA Metro Area",Bus,2016,736,1357,2093,0,
3381,39300,"Providence-New Bedford-Fall River, RI-MA Metro Area",Bus,2017,56,110,166,0,
3499,39300,"Providence-New Bedford-Fall River, RI-MA Metro Area",Bus,2017,156,625,781,0,
4027,39300,"Providence-New Bedford-Fall River, RI-MA Metro Area",Bus,2017,587,1467,2054,0,
3382,39300,"Providence-New Bedford-Fall River, RI-MA Metro Area",Bus,2018,42,117,159,0,
3501,39300,"Providence-New Bedford-Fall River, RI-MA Metro Area",Bus,2018,333,607,940,0,
4028,39300,"Providence-New Bedford-Fall River, RI-MA Metro Area",Bus,2018,679,1619,2298,0,
4029,39380,"Pueblo, CO Metro Area",Bus,2002,102,137,239,0,
4030,39380,"Pueblo, CO Metro Area",Bus,2003,103,87,190,0,
4031,39380,"Pueblo, CO Metro Area",Bus,2004,153,111,264,0,
4032,39380,"Pueblo, CO Metro Area",Bus,2005,157,96,253,0,
4033,39380,"Pueblo, CO Metro Area",Bus,2006,130,140,270,0,
4034,39380,"Pueblo, CO Metro Area",Bus,2007,123,153,276,0,
4035,39380,"Pueblo, CO Metro Area",Bus,2008,130,85,215,0,
4036,39380,"Pueblo, CO Metro Area",Bus,2009,69,233,302,0,
4037,39380,"Pueblo, CO Metro Area",Bus,2010,237,270,507,0,
4038,39380,"Pueblo, CO Metro Area",Bus,2011,109,33,142,0,
4039,39380,"Pueblo, CO Metro Area",Bus,2012,81,67,148,0,
4040,39380,"Pueblo, CO Metro Area",Bus,2013,98,74,172,0,
4041,39380,"Pueblo, CO Metro Area",Bus,2014,48,99,147,0,
4042,39380,"Pueblo, CO Metro Area",Bus,2015,55,110,165,0,
4043,39380,"Pueblo, CO Metro Area",Bus,2016,52,112,164,0,
4044,39380,"Pueblo, CO Metro Area",Bus,2017,26,20,46,0,
4045,39380,"Pueblo, CO Metro Area",Bus,2018,25,22,47,0,
4046,39540,"Racine, WI Metro Area",Bus,2002,67,13,80,0,
4047,39540,"Racine, WI Metro Area",Bus,2003,90,51,141,0,
4048,39540,"Racine, WI Metro Area",Bus,2004,112,76,188,0,
4049,39540,"Racine, WI Metro Area",Bus,2005,84,43,127,0,
4050,39540,"Racine, WI Metro Area",Bus,2006,120,64,184,0,
4051,39540,"Racine, WI Metro Area",Bus,2007,185,108,293,0,
4052,39540,"Racine, WI Metro Area",Bus,2008,185,58,243,0,
4053,39540,"Racine, WI Metro Area",Bus,2009,191,62,253,0,
4054,39540,"Racine, WI Metro Area",Bus,2010,243,52,295,0,
4055,39540,"Racine, WI Metro Area",Bus,2011,186,51,237,0,
4056,39540,"Racine, WI Metro Area",Bus,2012,110,39,149,0,
4057,39540,"Racine, WI Metro Area",Bus,2013,37,28,65,0,
4058,39540,"Racine, WI Metro Area",Bus,2014,123,22,145,0,
4059,39540,"Racine, WI Metro Area",Bus,2015,63,75,138,0,
4060,39540,"Racine, WI Metro Area",Bus,2016,44,120,164,0,
4061,39540,"Racine, WI Metro Area",Bus,2017,59,157,216,0,
4062,39540,"Racine, WI Metro Area",Bus,2018,66,181,247,0,
4063,39580,"Raleigh-Cary, NC Metro Area",Bus,2002,281,139,420,0,
4064,39580,"Raleigh-Cary, NC Metro Area",Bus,2003,434,300,734,0,
4065,39580,"Raleigh-Cary, NC Metro Area",Bus,2004,197,287,484,0,
4066,39580,"Raleigh-Cary, NC Metro Area",Bus,2005,266,230,496,0,
4067,39580,"Raleigh-Cary, NC Metro Area",Bus,2006,372,179,551,0,
4068,39580,"Raleigh-Cary, NC Metro Area",Bus,2007,419,110,529,0,
4069,39580,"Raleigh-Cary, NC Metro Area",Bus,2008,304,111,415,0,
4070,39580,"Raleigh-Cary, NC Metro Area",Bus,2009,402,95,497,0,
4071,39580,"Raleigh-Cary, NC Metro Area",Bus,2010,308,51,359,0,
4072,39580,"Raleigh-Cary, NC Metro Area",Bus,2011,281,40,321,0,
4073,39580,"Raleigh-Cary, NC Metro Area",Bus,2012,318,10,328,0,
4074,39580,"Raleigh-Cary, NC Metro Area",Bus,2013,296,8,304,0,
4075,39580,"Raleigh-Cary, NC Metro Area",Bus,2014,286,10,296,0,
4076,39580,"Raleigh-Cary, NC Metro Area",Bus,2015,398,13,411,0,
4077,39580,"Raleigh-Cary, NC Metro Area",Bus,2016,509,76,585,0,
4078,39580,"Raleigh-Cary, NC Metro Area",Bus,2017,544,72,616,0,
4079,39580,"Raleigh-Cary, NC Metro Area",Bus,2018,616,69,685,0,
3962,39740,"Reading, PA Metro Area",Bus,2002,0,0,0,0,
3964,39740,"Reading, PA Metro Area",Bus,2003,0,0,0,0,
3966,39740,"Reading, PA Metro Area",Bus,2004,0,0,0,0,
3968,39740,"Reading, PA Metro Area",Bus,2005,0,0,0,0,
3970,39740,"Reading, PA Metro Area",Bus,2006,0,0,0,0,
3972,39740,"Reading, PA Metro Area",Bus,2007,0,0,0,0,
3974,39740,"Reading, PA Metro Area",Bus,2008,0,0,0,0,
3976,39740,"Reading, PA Metro Area",Bus,2009,0,0,0,0,
3978,39740,"Reading, PA Metro Area",Bus,2010,0,0,0,0,
3980,39740,"Reading, PA Metro Area",Bus,2011,0,0,0,0,
3982,39740,"Reading, PA Metro Area",Bus,2012,2,1,3,0,
3984,39740,"Reading, PA Metro Area",Bus,2013,2,1,3,0,
3986,39740,"Reading, PA Metro Area",Bus,2014,2,5,7,0,
3988,39740,"Reading, PA Metro Area",Bus,2015,0,0,0,0,
3990,39740,"Reading, PA Metro Area",Bus,2016,4,3,7,0,
3992,39740,"Reading, PA Metro Area",Bus,2017,4,21,25,0,
3994,39740,"Reading, PA Metro Area",Bus,2018,4,95,99,0,
4080,39820,"Redding, CA Metro Area",Bus,2002,0,0,0,1,
4081,39820,"Redding, CA Metro Area",Bus,2003,0,0,0,1,
4082,39820,"Redding, CA Metro Area",Bus,2004,0,0,0,1,
4083,39820,"Redding, CA Metro Area",Bus,2005,0,0,0,1,
4084,39820,"Redding, CA Metro Area",Bus,2006,0,0,0,1,
4085,39820,"Redding, CA Metro Area",Bus,2007,0,0,0,1,
4086,39820,"Redding, CA Metro Area",Bus,2008,0,0,0,1,
4087,39820,"Redding, CA Metro Area",Bus,2009,4,8,12,0,
4088,39820,"Redding, CA Metro Area",Bus,2010,4,8,12,0,
4089,39820,"Redding, CA Metro Area",Bus,2011,6,12,18,0,
4090,39820,"Redding, CA Metro Area",Bus,2012,6,12,18,0,
4091,39820,"Redding, CA Metro Area",Bus,2013,6,12,18,0,
4092,39820,"Redding, CA Metro Area",Bus,2014,7,10,17,0,
4093,39820,"Redding, CA Metro Area",Bus,2015,7,13,20,0,
4094,39820,"Redding, CA Metro Area",Bus,2016,4,10,14,0,
4095,39820,"Redding, CA Metro Area",Bus,2017,21,44,65,0,
4096,39820,"Redding, CA Metro Area",Bus,2018,4,51,55,0,
4097,39900,"Reno-Sparks, NV Metro Area",Bus,2002,691,281,972,0,
4098,39900,"Reno-Sparks, NV Metro Area",Bus,2003,668,272,940,0,
4099,39900,"Reno-Sparks, NV Metro Area",Bus,2004,701,309,1010,0,
4100,39900,"Reno-Sparks, NV Metro Area",Bus,2005,736,353,1089,0,
4101,39900,"Reno-Sparks, NV Metro Area",Bus,2006,794,391,1185,0,
4102,39900,"Reno-Sparks, NV Metro Area",Bus,2007,864,415,1279,0,
4103,39900,"Reno-Sparks, NV Metro Area",Bus,2008,508,398,906,0,
4104,39900,"Reno-Sparks, NV Metro Area",Bus,2009,564,422,986,0,
4105,39900,"Reno-Sparks, NV Metro Area",Bus,2010,581,413,994,0,
4106,39900,"Reno-Sparks, NV Metro Area",Bus,2011,576,399,975,0,
4107,39900,"Reno-Sparks, NV Metro Area",Bus,2012,70,55,125,0,
4108,39900,"Reno-Sparks, NV Metro Area",Bus,2013,132,55,187,0,
4109,39900,"Reno-Sparks, NV Metro Area",Bus,2014,141,48,189,0,
4110,39900,"Reno-Sparks, NV Metro Area",Bus,2015,98,33,131,0,
4111,39900,"Reno-Sparks, NV Metro Area",Bus,2016,98,14,112,0,
4112,39900,"Reno-Sparks, NV Metro Area",Bus,2017,95,6,101,0,
4113,39900,"Reno-Sparks, NV Metro Area",Bus,2018,142,35,177,0,
4114,40060,"Richmond, VA Metro Area",Bus,2002,1224,716,1940,0,
4115,40060,"Richmond, VA Metro Area",Bus,2003,1303,516,1819,0,
4116,40060,"Richmond, VA Metro Area",Bus,2004,950,78,1028,0,
4117,40060,"Richmond, VA Metro Area",Bus,2005,1045,83,1128,0,
4118,40060,"Richmond, VA Metro Area",Bus,2006,1258,102,1360,0,
4119,40060,"Richmond, VA Metro Area",Bus,2007,1307,66,1373,0,
4120,40060,"Richmond, VA Metro Area",Bus,2008,1410,88,1498,0,
4121,40060,"Richmond, VA Metro Area",Bus,2009,1242,129,1371,0,
4122,40060,"Richmond, VA Metro Area",Bus,2010,1177,134,1311,0,
4123,40060,"Richmond, VA Metro Area",Bus,2011,1121,200,1321,0,
4124,40060,"Richmond, VA Metro Area",Bus,2012,1081,184,1265,0,
4125,40060,"Richmond, VA Metro Area",Bus,2013,967,136,1103,0,
4126,40060,"Richmond, VA Metro Area",Bus,2014,797,111,908,0,
4127,40060,"Richmond, VA Metro Area",Bus,2015,543,90,633,0,
4128,40060,"Richmond, VA Metro Area",Bus,2016,767,94,861,0,
4129,40060,"Richmond, VA Metro Area",Bus,2017,764,87,851,0,
4130,40060,"Richmond, VA Metro Area",Bus,2018,854,53,907,0,
2261,40140,"Riverside-San Bernardino-Ontario, CA Metro Area",Bus,2002,77,108,185,0,
4131,40140,"Riverside-San Bernardino-Ontario, CA Metro Area",Bus,2002,1595,1276,2871,0,
5270,40140,"Riverside-San Bernardino-Ontario, CA Metro Area",Bus,2002,0,0,0,0,
2262,40140,"Riverside-San Bernardino-Ontario, CA Metro Area",Bus,2003,10,163,173,0,
4132,40140,"Riverside-San Bernardino-Ontario, CA Metro Area",Bus,2003,2072,1785,3857,0,
5271,40140,"Riverside-San Bernardino-Ontario, CA Metro Area",Bus,2003,0,0,0,0,
2263,40140,"Riverside-San Bernardino-Ontario, CA Metro Area",Bus,2004,16,210,226,0,
4133,40140,"Riverside-San Bernardino-Ontario, CA Metro Area",Bus,2004,1670,1669,3339,0,
5272,40140,"Riverside-San Bernardino-Ontario, CA Metro Area",Bus,2004,0,0,0,0,
2264,40140,"Riverside-San Bernardino-Ontario, CA Metro Area",Bus,2005,37,183,220,0,
4134,40140,"Riverside-San Bernardino-Ontario, CA Metro Area",Bus,2005,2250,1429,3679,0,
5273,40140,"Riverside-San Bernardino-Ontario, CA Metro Area",Bus,2005,0,0,0,0,
2265,40140,"Riverside-San Bernardino-Ontario, CA Metro Area",Bus,2006,43,143,186,0,
4135,40140,"Riverside-San Bernardino-Ontario, CA Metro Area",Bus,2006,2154,1345,3499,0,
5274,40140,"Riverside-San Bernardino-Ontario, CA Metro Area",Bus,2006,0,0,0,0,
2266,40140,"Riverside-San Bernardino-Ontario, CA Metro Area",Bus,2007,15,145,160,0,
4136,40140,"Riverside-San Bernardino-Ontario, CA Metro Area",Bus,2007,2565,1431,3996,0,
5275,40140,"Riverside-San Bernardino-Ontario, CA Metro Area",Bus,2007,0,0,0,0,
2267,40140,"Riverside-San Bernardino-Ontario, CA Metro Area",Bus,2008,108,12,120,0,
4137,40140,"Riverside-San Bernardino-Ontario, CA Metro Area",Bus,2008,2491,1462,3953,0,
5276,40140,"Riverside-San Bernardino-Ontario, CA Metro Area",Bus,2008,86,26,112,0,
2268,40140,"Riverside-San Bernardino-Ontario, CA Metro Area",Bus,2009,21,74,95,0,
4138,40140,"Riverside-San Bernardino-Ontario, CA Metro Area",Bus,2009,1722,2039,3761,0,
5277,40140,"Riverside-San Bernardino-Ontario, CA Metro Area",Bus,2009,53,9,62,0,
2269,40140,"Riverside-San Bernardino-Ontario, CA Metro Area",Bus,2010,48,32,80,0,
4139,40140,"Riverside-San Bernardino-Ontario, CA Metro Area",Bus,2010,1227,2306,3533,0,
5278,40140,"Riverside-San Bernardino-Ontario, CA Metro Area",Bus,2010,103,8,111,0,
2270,40140,"Riverside-San Bernardino-Ontario, CA Metro Area",Bus,2011,29,95,124,0,
4140,40140,"Riverside-San Bernardino-Ontario, CA Metro Area",Bus,2011,1357,2128,3485,0,
5279,40140,"Riverside-San Bernardino-Ontario, CA Metro Area",Bus,2011,178,86,264,0,
2271,40140,"Riverside-San Bernardino-Ontario, CA Metro Area",Bus,2012,23,110,133,0,
4141,40140,"Riverside-San Bernardino-Ontario, CA Metro Area",Bus,2012,902,2206,3108,0,
5280,40140,"Riverside-San Bernardino-Ontario, CA Metro Area",Bus,2012,163,156,319,0,
2272,40140,"Riverside-San Bernardino-Ontario, CA Metro Area",Bus,2013,31,92,123,0,
4142,40140,"Riverside-San Bernardino-Ontario, CA Metro Area",Bus,2013,1015,1336,2351,0,
5281,40140,"Riverside-San Bernardino-Ontario, CA Metro Area",Bus,2013,194,236,430,0,
2273,40140,"Riverside-San Bernardino-Ontario, CA Metro Area",Bus,2014,33,125,158,0,
4143,40140,"Riverside-San Bernardino-Ontario, CA Metro Area",Bus,2014,1075,1075,2150,0,
5282,40140,"Riverside-San Bernardino-Ontario, CA Metro Area",Bus,2014,161,276,437,0,
2274,40140,"Riverside-San Bernardino-Ontario, CA Metro Area",Bus,2015,113,23,136,0,
4144,40140,"Riverside-San Bernardino-Ontario, CA Metro Area",Bus,2015,1122,775,1897,0,
5283,40140,"Riverside-San Bernardino-Ontario, CA Metro Area",Bus,2015,173,275,448,0,
2275,40140,"Riverside-San Bernardino-Ontario, CA Metro Area",Bus,2016,258,4,262,0,
4145,40140,"Riverside-San Bernardino-Ontario, CA Metro Area",Bus,2016,1136,926,2062,0,
5284,40140,"Riverside-San Bernardino-Ontario, CA Metro Area",Bus,2016,181,292,473,0,
2276,40140,"Riverside-San Bernardino-Ontario, CA Metro Area",Bus,2017,373,72,445,0,
4146,40140,"Riverside-San Bernardino-Ontario, CA Metro Area",Bus,2017,924,815,1739,0,
5285,40140,"Riverside-San Bernardino-Ontario, CA Metro Area",Bus,2017,308,190,498,0,
2277,40140,"Riverside-San Bernardino-Ontario, CA Metro Area",Bus,2018,508,127,635,0,
4147,40140,"Riverside-San Bernardino-Ontario, CA Metro Area",Bus,2018,844,1008,1852,0,
5286,40140,"Riverside-San Bernardino-Ontario, CA Metro Area",Bus,2018,393,187,580,0,
4148,40220,"Roanoke, VA Metro Area",Bus,2002,6,251,257,0,
4149,40220,"Roanoke, VA Metro Area",Bus,2003,5,284,289,0,
4150,40220,"Roanoke, VA Metro Area",Bus,2004,7,272,279,0,
4151,40220,"Roanoke, VA Metro Area",Bus,2005,13,251,264,0,
4152,40220,"Roanoke, VA Metro Area",Bus,2006,47,246,293,0,
4153,40220,"Roanoke, VA Metro Area",Bus,2007,4,241,245,0,
4154,40220,"Roanoke, VA Metro Area",Bus,2008,4,189,193,0,
4155,40220,"Roanoke, VA Metro Area",Bus,2009,4,241,245,0,
4156,40220,"Roanoke, VA Metro Area",Bus,2010,2,237,239,0,
4157,40220,"Roanoke, VA Metro Area",Bus,2011,5,253,258,0,
4158,40220,"Roanoke, VA Metro Area",Bus,2012,0,223,223,0,
4159,40220,"Roanoke, VA Metro Area",Bus,2013,2,218,220,0,
4160,40220,"Roanoke, VA Metro Area",Bus,2014,2,278,280,0,
4161,40220,"Roanoke, VA Metro Area",Bus,2015,2,291,293,0,
4162,40220,"Roanoke, VA Metro Area",Bus,2016,2,294,296,0,
4163,40220,"Roanoke, VA Metro Area",Bus,2017,1,308,309,0,
4164,40220,"Roanoke, VA Metro Area",Bus,2018,0,241,241,0,
4165,40340,"Rochester, MN Metro Area",Bus,2002,0,0,0,1,
4166,40340,"Rochester, MN Metro Area",Bus,2003,0,0,0,1,
4167,40340,"Rochester, MN Metro Area",Bus,2004,0,0,0,1,
4168,40340,"Rochester, MN Metro Area",Bus,2005,0,0,0,1,
4169,40340,"Rochester, MN Metro Area",Bus,2006,0,0,0,1,
4170,40340,"Rochester, MN Metro Area",Bus,2007,0,0,0,1,
4171,40340,"Rochester, MN Metro Area",Bus,2008,0,0,0,1,
4172,40340,"Rochester, MN Metro Area",Bus,2009,75,41,116,0,
4173,40340,"Rochester, MN Metro Area",Bus,2010,63,34,97,0,
4174,40340,"Rochester, MN Metro Area",Bus,2011,41,16,57,0,
4175,40340,"Rochester, MN Metro Area",Bus,2012,51,19,70,0,
4176,40340,"Rochester, MN Metro Area",Bus,2013,66,44,110,0,
4177,40340,"Rochester, MN Metro Area",Bus,2014,71,39,110,0,
4178,40340,"Rochester, MN Metro Area",Bus,2015,76,29,105,0,
4179,40340,"Rochester, MN Metro Area",Bus,2016,117,50,167,0,
4180,40340,"Rochester, MN Metro Area",Bus,2017,60,83,143,0,
4181,40340,"Rochester, MN Metro Area",Bus,2018,77,93,170,0,
4182,40380,"Rochester, NY Metro Area",Bus,2002,463,73,536,0,
4183,40380,"Rochester, NY Metro Area",Bus,2003,608,132,740,0,
4184,40380,"Rochester, NY Metro Area",Bus,2004,381,1907,2288,0,
4185,40380,"Rochester, NY Metro Area",Bus,2005,349,1806,2155,0,
4186,40380,"Rochester, NY Metro Area",Bus,2006,101,1351,1452,0,
4187,40380,"Rochester, NY Metro Area",Bus,2007,187,1040,1227,0,
4188,40380,"Rochester, NY Metro Area",Bus,2008,534,705,1239,0,
4189,40380,"Rochester, NY Metro Area",Bus,2009,685,817,1502,0,
4190,40380,"Rochester, NY Metro Area",Bus,2010,597,707,1304,0,
4191,40380,"Rochester, NY Metro Area",Bus,2011,436,569,1005,0,
4192,40380,"Rochester, NY Metro Area",Bus,2012,327,458,785,0,
4193,40380,"Rochester, NY Metro Area",Bus,2013,439,535,974,0,
4194,40380,"Rochester, NY Metro Area",Bus,2014,346,509,855,0,
4195,40380,"Rochester, NY Metro Area",Bus,2015,327,108,435,0,
4196,40380,"Rochester, NY Metro Area",Bus,2016,343,86,429,0,
4197,40380,"Rochester, NY Metro Area",Bus,2017,307,77,384,0,
4198,40380,"Rochester, NY Metro Area",Bus,2018,284,71,355,0,
4199,40420,"Rockford, IL Metro Area",Bus,2002,121,119,240,0,
4200,40420,"Rockford, IL Metro Area",Bus,2003,144,125,269,0,
4201,40420,"Rockford, IL Metro Area",Bus,2004,206,73,279,0,
4202,40420,"Rockford, IL Metro Area",Bus,2005,222,86,308,0,
4203,40420,"Rockford, IL Metro Area",Bus,2006,239,103,342,0,
4204,40420,"Rockford, IL Metro Area",Bus,2007,292,136,428,0,
4205,40420,"Rockford, IL Metro Area",Bus,2008,324,92,416,0,
4206,40420,"Rockford, IL Metro Area",Bus,2009,327,86,413,0,
4207,40420,"Rockford, IL Metro Area",Bus,2010,316,59,375,0,
4208,40420,"Rockford, IL Metro Area",Bus,2011,325,60,385,0,
4209,40420,"Rockford, IL Metro Area",Bus,2012,318,72,390,0,
4210,40420,"Rockford, IL Metro Area",Bus,2013,269,72,341,0,
4211,40420,"Rockford, IL Metro Area",Bus,2014,334,94,428,0,
4212,40420,"Rockford, IL Metro Area",Bus,2015,369,106,475,0,
4213,40420,"Rockford, IL Metro Area",Bus,2016,333,75,408,0,
4214,40420,"Rockford, IL Metro Area",Bus,2017,335,100,435,0,
4215,40420,"Rockford, IL Metro Area",Bus,2018,350,82,432,0,
4216,40660,"Rome, GA Metro Area",Bus,2002,70,39,109,0,
4217,40660,"Rome, GA Metro Area",Bus,2003,80,41,121,0,
4218,40660,"Rome, GA Metro Area",Bus,2004,83,26,109,0,
4219,40660,"Rome, GA Metro Area",Bus,2005,56,19,75,0,
4220,40660,"Rome, GA Metro Area",Bus,2006,107,81,188,0,
4221,40660,"Rome, GA Metro Area",Bus,2007,149,214,363,0,
4222,40660,"Rome, GA Metro Area",Bus,2008,141,67,208,0,
4223,40660,"Rome, GA Metro Area",Bus,2009,140,116,256,0,
4224,40660,"Rome, GA Metro Area",Bus,2010,96,178,274,0,
4225,40660,"Rome, GA Metro Area",Bus,2011,87,74,161,0,
4226,40660,"Rome, GA Metro Area",Bus,2012,90,69,159,0,
4227,40660,"Rome, GA Metro Area",Bus,2013,95,163,258,0,
4228,40660,"Rome, GA Metro Area",Bus,2014,43,75,118,0,
4229,40660,"Rome, GA Metro Area",Bus,2015,52,50,102,0,
4230,40660,"Rome, GA Metro Area",Bus,2016,94,19,113,0,
4231,40660,"Rome, GA Metro Area",Bus,2017,83,26,109,0,
4232,40660,"Rome, GA Metro Area",Bus,2018,76,59,135,0,
1309,40900,"Sacramento--Arden-Arcade--Roseville, CA Metro Area",Bus,2002,8,7,15,0,
4233,40900,"Sacramento--Arden-Arcade--Roseville, CA Metro Area",Bus,2002,1181,94,1275,0,
1310,40900,"Sacramento--Arden-Arcade--Roseville, CA Metro Area",Bus,2003,11,7,18,0,
4234,40900,"Sacramento--Arden-Arcade--Roseville, CA Metro Area",Bus,2003,1047,7,1054,0,
1311,40900,"Sacramento--Arden-Arcade--Roseville, CA Metro Area",Bus,2004,10,3,13,0,
4235,40900,"Sacramento--Arden-Arcade--Roseville, CA Metro Area",Bus,2004,1693,338,2031,0,
1312,40900,"Sacramento--Arden-Arcade--Roseville, CA Metro Area",Bus,2005,34,1,35,0,
4236,40900,"Sacramento--Arden-Arcade--Roseville, CA Metro Area",Bus,2005,1530,421,1951,0,
1313,40900,"Sacramento--Arden-Arcade--Roseville, CA Metro Area",Bus,2006,11,2,13,0,
4237,40900,"Sacramento--Arden-Arcade--Roseville, CA Metro Area",Bus,2006,1304,553,1857,0,
1314,40900,"Sacramento--Arden-Arcade--Roseville, CA Metro Area",Bus,2007,21,3,24,0,
4238,40900,"Sacramento--Arden-Arcade--Roseville, CA Metro Area",Bus,2007,801,509,1310,0,
1315,40900,"Sacramento--Arden-Arcade--Roseville, CA Metro Area",Bus,2008,28,7,35,0,
4239,40900,"Sacramento--Arden-Arcade--Roseville, CA Metro Area",Bus,2008,1072,342,1414,0,
1316,40900,"Sacramento--Arden-Arcade--Roseville, CA Metro Area",Bus,2009,21,5,26,0,
4240,40900,"Sacramento--Arden-Arcade--Roseville, CA Metro Area",Bus,2009,945,219,1164,0,
1317,40900,"Sacramento--Arden-Arcade--Roseville, CA Metro Area",Bus,2010,41,13,54,0,
4241,40900,"Sacramento--Arden-Arcade--Roseville, CA Metro Area",Bus,2010,934,284,1218,0,
1318,40900,"Sacramento--Arden-Arcade--Roseville, CA Metro Area",Bus,2011,29,10,39,0,
4242,40900,"Sacramento--Arden-Arcade--Roseville, CA Metro Area",Bus,2011,790,293,1083,0,
1319,40900,"Sacramento--Arden-Arcade--Roseville, CA Metro Area",Bus,2012,45,8,53,0,
4243,40900,"Sacramento--Arden-Arcade--Roseville, CA Metro Area",Bus,2012,765,236,1001,0,
1320,40900,"Sacramento--Arden-Arcade--Roseville, CA Metro Area",Bus,2013,67,10,77,0,
4244,40900,"Sacramento--Arden-Arcade--Roseville, CA Metro Area",Bus,2013,980,277,1257,0,
1321,40900,"Sacramento--Arden-Arcade--Roseville, CA Metro Area",Bus,2014,43,9,52,0,
4245,40900,"Sacramento--Arden-Arcade--Roseville, CA Metro Area",Bus,2014,951,99,1050,0,
1322,40900,"Sacramento--Arden-Arcade--Roseville, CA Metro Area",Bus,2015,54,22,76,0,
4246,40900,"Sacramento--Arden-Arcade--Roseville, CA Metro Area",Bus,2015,1030,156,1186,0,
1323,40900,"Sacramento--Arden-Arcade--Roseville, CA Metro Area",Bus,2016,81,14,95,0,
4247,40900,"Sacramento--Arden-Arcade--Roseville, CA Metro Area",Bus,2016,1220,204,1424,0,
1324,40900,"Sacramento--Arden-Arcade--Roseville, CA Metro Area",Bus,2017,48,13,61,0,
4248,40900,"Sacramento--Arden-Arcade--Roseville, CA Metro Area",Bus,2017,969,260,1229,0,
1325,40900,"Sacramento--Arden-Arcade--Roseville, CA Metro Area",Bus,2018,57,27,84,0,
4249,40900,"Sacramento--Arden-Arcade--Roseville, CA Metro Area",Bus,2018,924,243,1167,0,
4250,40900,"Sacramento--Arden-Arcade--Roseville, CA Metro Area",Rail,2002,33,7,40,0,
4251,40900,"Sacramento--Arden-Arcade--Roseville, CA Metro Area",Rail,2003,42,99,141,0,
4252,40900,"Sacramento--Arden-Arcade--Roseville, CA Metro Area",Rail,2004,70,85,155,0,
4253,40900,"Sacramento--Arden-Arcade--Roseville, CA Metro Area",Rail,2005,264,11,275,0,
4254,40900,"Sacramento--Arden-Arcade--Roseville, CA Metro Area",Rail,2006,198,58,256,0,
4255,40900,"Sacramento--Arden-Arcade--Roseville, CA Metro Area",Rail,2007,231,98,329,0,
4256,40900,"Sacramento--Arden-Arcade--Roseville, CA Metro Area",Rail,2008,219,84,303,0,
4257,40900,"Sacramento--Arden-Arcade--Roseville, CA Metro Area",Rail,2009,114,83,197,0,
4258,40900,"Sacramento--Arden-Arcade--Roseville, CA Metro Area",Rail,2010,76,102,178,0,
4259,40900,"Sacramento--Arden-Arcade--Roseville, CA Metro Area",Rail,2011,98,79,177,0,
4260,40900,"Sacramento--Arden-Arcade--Roseville, CA Metro Area",Rail,2012,49,40,89,0,
4261,40900,"Sacramento--Arden-Arcade--Roseville, CA Metro Area",Rail,2013,217,29,246,0,
4262,40900,"Sacramento--Arden-Arcade--Roseville, CA Metro Area",Rail,2014,215,45,260,0,
4263,40900,"Sacramento--Arden-Arcade--Roseville, CA Metro Area",Rail,2015,239,73,312,0,
4264,40900,"Sacramento--Arden-Arcade--Roseville, CA Metro Area",Rail,2016,202,167,369,0,
4265,40900,"Sacramento--Arden-Arcade--Roseville, CA Metro Area",Rail,2017,381,53,434,0,
4266,40900,"Sacramento--Arden-Arcade--Roseville, CA Metro Area",Rail,2018,399,109,508,0,
4267,40980,"Saginaw-Saginaw Township North, MI Metro Area",Bus,2002,3,0,3,1,
4268,40980,"Saginaw-Saginaw Township North, MI Metro Area",Bus,2003,2,30,32,1,
4269,40980,"Saginaw-Saginaw Township North, MI Metro Area",Bus,2004,4,66,70,0,
4270,40980,"Saginaw-Saginaw Township North, MI Metro Area",Bus,2005,49,108,157,0,
4271,40980,"Saginaw-Saginaw Township North, MI Metro Area",Bus,2006,44,189,233,0,
4272,40980,"Saginaw-Saginaw Township North, MI Metro Area",Bus,2007,54,166,220,0,
4273,40980,"Saginaw-Saginaw Township North, MI Metro Area",Bus,2008,21,156,177,0,
4274,40980,"Saginaw-Saginaw Township North, MI Metro Area",Bus,2009,34,98,132,0,
4275,40980,"Saginaw-Saginaw Township North, MI Metro Area",Bus,2010,15,91,106,0,
4276,40980,"Saginaw-Saginaw Township North, MI Metro Area",Bus,2011,12,89,101,0,
4277,40980,"Saginaw-Saginaw Township North, MI Metro Area",Bus,2012,17,99,116,0,
4278,40980,"Saginaw-Saginaw Township North, MI Metro Area",Bus,2013,13,88,101,0,
4279,40980,"Saginaw-Saginaw Township North, MI Metro Area",Bus,2014,63,15,78,0,
4280,40980,"Saginaw-Saginaw Township North, MI Metro Area",Bus,2015,18,81,99,0,
4281,40980,"Saginaw-Saginaw Township North, MI Metro Area",Bus,2016,5,100,105,0,
4282,40980,"Saginaw-Saginaw Township North, MI Metro Area",Bus,2017,13,60,73,0,
4283,40980,"Saginaw-Saginaw Township North, MI Metro Area",Bus,2018,42,30,72,0,
4862,41060,"St. Cloud, MN Metro Area",Bus,2002,9,7,16,0,
4863,41060,"St. Cloud, MN Metro Area",Bus,2003,5,4,9,0,
4864,41060,"St. Cloud, MN Metro Area",Bus,2004,10,1,11,0,
4865,41060,"St. Cloud, MN Metro Area",Bus,2005,14,2,16,0,
4866,41060,"St. Cloud, MN Metro Area",Bus,2006,14,1,15,0,
4867,41060,"St. Cloud, MN Metro Area",Bus,2007,9,0,9,0,
4868,41060,"St. Cloud, MN Metro Area",Bus,2008,12,0,12,0,
4869,41060,"St. Cloud, MN Metro Area",Bus,2009,16,3,19,0,
4870,41060,"St. Cloud, MN Metro Area",Bus,2010,15,3,18,0,
4871,41060,"St. Cloud, MN Metro Area",Bus,2011,25,3,28,0,
4872,41060,"St. Cloud, MN Metro Area",Bus,2012,76,38,114,0,
4873,41060,"St. Cloud, MN Metro Area",Bus,2013,87,44,131,0,
4874,41060,"St. Cloud, MN Metro Area",Bus,2014,39,36,75,0,
4875,41060,"St. Cloud, MN Metro Area",Bus,2015,30,8,38,0,
4876,41060,"St. Cloud, MN Metro Area",Bus,2016,25,20,45,0,
4877,41060,"St. Cloud, MN Metro Area",Bus,2017,45,81,126,0,
4878,41060,"St. Cloud, MN Metro Area",Bus,2018,27,87,114,0,
4879,41180,"St. Louis, MO-IL Metro Area",Bus,2002,1327,445,1772,0,
4880,41180,"St. Louis, MO-IL Metro Area",Bus,2003,747,264,1011,0,
4881,41180,"St. Louis, MO-IL Metro Area",Bus,2004,716,129,845,0,
4882,41180,"St. Louis, MO-IL Metro Area",Bus,2005,660,157,817,0,
4883,41180,"St. Louis, MO-IL Metro Area",Bus,2006,604,160,764,0,
4884,41180,"St. Louis, MO-IL Metro Area",Bus,2007,552,144,696,0,
4885,41180,"St. Louis, MO-IL Metro Area",Bus,2008,569,185,754,0,
4886,41180,"St. Louis, MO-IL Metro Area",Bus,2009,577,213,790,0,
4887,41180,"St. Louis, MO-IL Metro Area",Bus,2010,479,181,660,0,
4888,41180,"St. Louis, MO-IL Metro Area",Bus,2011,515,225,740,0,
4889,41180,"St. Louis, MO-IL Metro Area",Bus,2012,522,251,773,0,
4890,41180,"St. Louis, MO-IL Metro Area",Bus,2013,452,227,679,0,
4891,41180,"St. Louis, MO-IL Metro Area",Bus,2014,507,214,721,0,
4892,41180,"St. Louis, MO-IL Metro Area",Bus,2015,481,222,703,0,
4893,41180,"St. Louis, MO-IL Metro Area",Bus,2016,618,233,851,0,
4894,41180,"St. Louis, MO-IL Metro Area",Bus,2017,670,204,874,0,
4895,41180,"St. Louis, MO-IL Metro Area",Bus,2018,600,210,810,0,
4896,41180,"St. Louis, MO-IL Metro Area",Rail,2002,1,296,297,0,
4897,41180,"St. Louis, MO-IL Metro Area",Rail,2003,3,329,332,0,
4898,41180,"St. Louis, MO-IL Metro Area",Rail,2004,2,326,328,0,
4899,41180,"St. Louis, MO-IL Metro Area",Rail,2005,3,328,331,0,
4900,41180,"St. Louis, MO-IL Metro Area",Rail,2006,7,291,298,0,
4901,41180,"St. Louis, MO-IL Metro Area",Rail,2007,8,333,341,0,
4902,41180,"St. Louis, MO-IL Metro Area",Rail,2008,8,356,364,0,
4903,41180,"St. Louis, MO-IL Metro Area",Rail,2009,14,359,373,0,
4904,41180,"St. Louis, MO-IL Metro Area",Rail,2010,291,143,434,0,
4905,41180,"St. Louis, MO-IL Metro Area",Rail,2011,328,192,520,0,
4906,41180,"St. Louis, MO-IL Metro Area",Rail,2012,205,89,294,0,
4907,41180,"St. Louis, MO-IL Metro Area",Rail,2013,278,118,396,0,
4908,41180,"St. Louis, MO-IL Metro Area",Rail,2014,298,86,384,0,
4909,41180,"St. Louis, MO-IL Metro Area",Rail,2015,240,80,320,0,
4910,41180,"St. Louis, MO-IL Metro Area",Rail,2016,296,78,374,0,
4911,41180,"St. Louis, MO-IL Metro Area",Rail,2017,286,71,357,0,
4912,41180,"St. Louis, MO-IL Metro Area",Rail,2018,282,45,327,0,
4284,41420,"Salem, OR Metro Area",Bus,2002,68,15,83,0,
4285,41420,"Salem, OR Metro Area",Bus,2003,45,16,61,0,
4286,41420,"Salem, OR Metro Area",Bus,2004,73,13,86,0,
4287,41420,"Salem, OR Metro Area",Bus,2005,64,22,86,0,
4288,41420,"Salem, OR Metro Area",Bus,2006,53,18,71,0,
4289,41420,"Salem, OR Metro Area",Bus,2007,60,18,78,0,
4290,41420,"Salem, OR Metro Area",Bus,2008,60,10,70,0,
4291,41420,"Salem, OR Metro Area",Bus,2009,52,19,71,0,
4292,41420,"Salem, OR Metro Area",Bus,2010,126,23,149,0,
4293,41420,"Salem, OR Metro Area",Bus,2011,200,69,269,0,
4294,41420,"Salem, OR Metro Area",Bus,2012,139,109,248,0,
4295,41420,"Salem, OR Metro Area",Bus,2013,175,112,287,0,
4296,41420,"Salem, OR Metro Area",Bus,2014,176,70,246,0,
4297,41420,"Salem, OR Metro Area",Bus,2015,169,104,273,0,
4298,41420,"Salem, OR Metro Area",Bus,2016,214,131,345,0,
4299,41420,"Salem, OR Metro Area",Bus,2017,214,131,345,0,
4300,41420,"Salem, OR Metro Area",Bus,2018,189,103,292,0,
4624,41500,"Salinas, CA Metro Area",Bus,2002,426,476,902,0,
4625,41500,"Salinas, CA Metro Area",Bus,2003,266,342,608,0,
4626,41500,"Salinas, CA Metro Area",Bus,2004,264,134,398,0,
4627,41500,"Salinas, CA Metro Area",Bus,2005,264,188,452,0,
4628,41500,"Salinas, CA Metro Area",Bus,2006,326,194,520,0,
4629,41500,"Salinas, CA Metro Area",Bus,2007,142,141,283,0,
4630,41500,"Salinas, CA Metro Area",Bus,2008,123,128,251,0,
4631,41500,"Salinas, CA Metro Area",Bus,2009,296,4,300,0,
4632,41500,"Salinas, CA Metro Area",Bus,2010,316,4,320,0,
4633,41500,"Salinas, CA Metro Area",Bus,2011,6,296,302,0,
4634,41500,"Salinas, CA Metro Area",Bus,2012,150,152,302,0,
4635,41500,"Salinas, CA Metro Area",Bus,2013,213,66,279,0,
4636,41500,"Salinas, CA Metro Area",Bus,2014,251,48,299,0,
4637,41500,"Salinas, CA Metro Area",Bus,2015,233,39,272,0,
4638,41500,"Salinas, CA Metro Area",Bus,2016,280,52,332,0,
4639,41500,"Salinas, CA Metro Area",Bus,2017,247,81,328,0,
4640,41500,"Salinas, CA Metro Area",Bus,2018,250,59,309,0,
4301,41540,"Salisbury, MD Metro Area",Bus,2002,0,0,0,1,
4302,41540,"Salisbury, MD Metro Area",Bus,2003,0,0,0,1,
4303,41540,"Salisbury, MD Metro Area",Bus,2004,0,0,0,1,
4304,41540,"Salisbury, MD Metro Area",Bus,2005,0,0,0,1,
4305,41540,"Salisbury, MD Metro Area",Bus,2006,166,280,446,0,
4306,41540,"Salisbury, MD Metro Area",Bus,2007,274,169,443,0,
4307,41540,"Salisbury, MD Metro Area",Bus,2008,239,369,608,0,
4308,41540,"Salisbury, MD Metro Area",Bus,2009,478,58,536,0,
4309,41540,"Salisbury, MD Metro Area",Bus,2010,359,493,852,0,
4310,41540,"Salisbury, MD Metro Area",Bus,2011,139,69,208,0,
4311,41540,"Salisbury, MD Metro Area",Bus,2012,121,84,205,0,
4312,41540,"Salisbury, MD Metro Area",Bus,2013,134,39,173,0,
4313,41540,"Salisbury, MD Metro Area",Bus,2014,218,96,314,0,
4314,41540,"Salisbury, MD Metro Area",Bus,2015,205,97,302,0,
4315,41540,"Salisbury, MD Metro Area",Bus,2016,262,55,317,0,
4316,41540,"Salisbury, MD Metro Area",Bus,2017,196,72,268,0,
4317,41540,"Salisbury, MD Metro Area",Bus,2018,115,72,187,0,
4318,41620,"Salt Lake City, UT Metro Area",Bus,2002,29,154,183,0,
4319,41620,"Salt Lake City, UT Metro Area",Bus,2003,48,224,272,0,
4320,41620,"Salt Lake City, UT Metro Area",Bus,2004,1625,213,1838,0,
4321,41620,"Salt Lake City, UT Metro Area",Bus,2005,1507,169,1676,0,
4322,41620,"Salt Lake City, UT Metro Area",Bus,2006,1428,189,1617,0,
4323,41620,"Salt Lake City, UT Metro Area",Bus,2007,1516,157,1673,0,
4324,41620,"Salt Lake City, UT Metro Area",Bus,2008,1567,191,1758,0,
4325,41620,"Salt Lake City, UT Metro Area",Bus,2009,1389,174,1563,0,
4326,41620,"Salt Lake City, UT Metro Area",Bus,2010,1477,192,1669,0,
4327,41620,"Salt Lake City, UT Metro Area",Bus,2011,1316,196,1512,0,
4328,41620,"Salt Lake City, UT Metro Area",Bus,2012,1217,106,1323,0,
4329,41620,"Salt Lake City, UT Metro Area",Bus,2013,1162,101,1263,0,
4330,41620,"Salt Lake City, UT Metro Area",Bus,2014,1050,124,1174,0,
4331,41620,"Salt Lake City, UT Metro Area",Bus,2015,1857,397,2254,0,
4332,41620,"Salt Lake City, UT Metro Area",Bus,2016,1010,654,1664,0,
4333,41620,"Salt Lake City, UT Metro Area",Bus,2017,991,580,1571,0,
4334,41620,"Salt Lake City, UT Metro Area",Bus,2018,780,579,1359,0,
4335,41620,"Salt Lake City, UT Metro Area",Rail,2002,4,20,24,0,
4336,41620,"Salt Lake City, UT Metro Area",Rail,2003,3,10,13,0,
4337,41620,"Salt Lake City, UT Metro Area",Rail,2004,22,0,22,0,
4338,41620,"Salt Lake City, UT Metro Area",Rail,2005,65,0,65,0,
4339,41620,"Salt Lake City, UT Metro Area",Rail,2006,151,0,151,0,
4340,41620,"Salt Lake City, UT Metro Area",Rail,2007,106,0,106,0,
4341,41620,"Salt Lake City, UT Metro Area",Rail,2008,130,0,130,0,
4342,41620,"Salt Lake City, UT Metro Area",Rail,2009,159,0,159,0,
4343,41620,"Salt Lake City, UT Metro Area",Rail,2010,159,0,159,0,
4344,41620,"Salt Lake City, UT Metro Area",Rail,2011,28,37,65,0,
4345,41620,"Salt Lake City, UT Metro Area",Rail,2012,69,16,85,0,
4346,41620,"Salt Lake City, UT Metro Area",Rail,2013,69,19,88,0,
4347,41620,"Salt Lake City, UT Metro Area",Rail,2014,30,70,100,0,
4348,41620,"Salt Lake City, UT Metro Area",Rail,2015,178,118,296,0,
4349,41620,"Salt Lake City, UT Metro Area",Rail,2016,241,79,320,0,
4350,41620,"Salt Lake City, UT Metro Area",Rail,2017,253,196,449,0,
4351,41620,"Salt Lake City, UT Metro Area",Rail,2018,355,258,613,0,
4352,41660,"San Angelo, TX Metro Area",Bus,2002,98,81,179,0,
4353,41660,"San Angelo, TX Metro Area",Bus,2003,85,37,122,0,
4354,41660,"San Angelo, TX Metro Area",Bus,2004,51,32,83,0,
4355,41660,"San Angelo, TX Metro Area",Bus,2005,131,143,274,0,
4356,41660,"San Angelo, TX Metro Area",Bus,2006,108,144,252,0,
4357,41660,"San Angelo, TX Metro Area",Bus,2007,80,148,228,0,
4358,41660,"San Angelo, TX Metro Area",Bus,2008,59,29,88,0,
4359,41660,"San Angelo, TX Metro Area",Bus,2009,67,22,89,0,
4360,41660,"San Angelo, TX Metro Area",Bus,2010,62,15,77,0,
4361,41660,"San Angelo, TX Metro Area",Bus,2011,60,17,77,0,
4362,41660,"San Angelo, TX Metro Area",Bus,2012,15,48,63,0,
4363,41660,"San Angelo, TX Metro Area",Bus,2013,14,12,26,0,
4364,41660,"San Angelo, TX Metro Area",Bus,2014,35,10,45,0,
4365,41660,"San Angelo, TX Metro Area",Bus,2015,8,3,11,0,
4366,41660,"San Angelo, TX Metro Area",Bus,2016,2,0,2,0,
4367,41660,"San Angelo, TX Metro Area",Bus,2017,34,56,90,0,
4368,41660,"San Angelo, TX Metro Area",Bus,2018,10,41,51,0,
4369,41700,"San Antonio-New Braunfels, TX Metro Area",Bus,2002,4255,2692,6947,0,
4370,41700,"San Antonio-New Braunfels, TX Metro Area",Bus,2003,8005,973,8978,0,
4371,41700,"San Antonio-New Braunfels, TX Metro Area",Bus,2004,5926,2554,8480,0,
4372,41700,"San Antonio-New Braunfels, TX Metro Area",Bus,2005,7100,2006,9106,0,
4373,41700,"San Antonio-New Braunfels, TX Metro Area",Bus,2006,6428,2604,9032,0,
4374,41700,"San Antonio-New Braunfels, TX Metro Area",Bus,2007,4178,1790,5968,0,
4375,41700,"San Antonio-New Braunfels, TX Metro Area",Bus,2008,4280,2000,6280,0,
4376,41700,"San Antonio-New Braunfels, TX Metro Area",Bus,2009,3404,1992,5396,0,
4377,41700,"San Antonio-New Braunfels, TX Metro Area",Bus,2010,3898,2319,6217,0,
4378,41700,"San Antonio-New Braunfels, TX Metro Area",Bus,2011,3681,2951,6632,0,
4379,41700,"San Antonio-New Braunfels, TX Metro Area",Bus,2012,3735,2418,6153,0,
4380,41700,"San Antonio-New Braunfels, TX Metro Area",Bus,2013,3204,2852,6056,0,
4381,41700,"San Antonio-New Braunfels, TX Metro Area",Bus,2014,4487,6017,10504,0,
4382,41700,"San Antonio-New Braunfels, TX Metro Area",Bus,2015,3574,2045,5619,0,
4383,41700,"San Antonio-New Braunfels, TX Metro Area",Bus,2016,1706,5400,7106,0,
4384,41700,"San Antonio-New Braunfels, TX Metro Area",Bus,2017,5698,925,6623,0,
4385,41700,"San Antonio-New Braunfels, TX Metro Area",Bus,2018,2414,3231,5645,0,
4386,41740,"San Diego-Carlsbad-San Marcos, CA Metro Area",Bus,2002,4122,1600,5722,0,
4387,41740,"San Diego-Carlsbad-San Marcos, CA Metro Area",Bus,2003,1809,725,2534,0,
4388,41740,"San Diego-Carlsbad-San Marcos, CA Metro Area",Bus,2004,1613,260,1873,0,
4389,41740,"San Diego-Carlsbad-San Marcos, CA Metro Area",Bus,2005,962,631,1593,0,
4390,41740,"San Diego-Carlsbad-San Marcos, CA Metro Area",Bus,2006,848,670,1518,0,
4391,41740,"San Diego-Carlsbad-San Marcos, CA Metro Area",Bus,2007,949,236,1185,0,
4392,41740,"San Diego-Carlsbad-San Marcos, CA Metro Area",Bus,2008,1779,197,1976,0,
4393,41740,"San Diego-Carlsbad-San Marcos, CA Metro Area",Bus,2009,2989,601,3590,0,
4394,41740,"San Diego-Carlsbad-San Marcos, CA Metro Area",Bus,2010,3010,322,3332,0,
4395,41740,"San Diego-Carlsbad-San Marcos, CA Metro Area",Bus,2011,2445,478,2923,0,
4396,41740,"San Diego-Carlsbad-San Marcos, CA Metro Area",Bus,2012,2175,709,2884,0,
4397,41740,"San Diego-Carlsbad-San Marcos, CA Metro Area",Bus,2013,2302,391,2693,0,
4398,41740,"San Diego-Carlsbad-San Marcos, CA Metro Area",Bus,2014,2423,1260,3683,0,
4399,41740,"San Diego-Carlsbad-San Marcos, CA Metro Area",Bus,2015,2572,281,2853,0,
4400,41740,"San Diego-Carlsbad-San Marcos, CA Metro Area",Bus,2016,3215,697,3912,0,
4401,41740,"San Diego-Carlsbad-San Marcos, CA Metro Area",Bus,2017,3072,632,3704,0,
4402,41740,"San Diego-Carlsbad-San Marcos, CA Metro Area",Bus,2018,2880,448,3328,0,
4403,41740,"San Diego-Carlsbad-San Marcos, CA Metro Area",Rail,2002,18,175,193,0,
4404,41740,"San Diego-Carlsbad-San Marcos, CA Metro Area",Rail,2003,1,164,165,0,
4405,41740,"San Diego-Carlsbad-San Marcos, CA Metro Area",Rail,2004,2,148,150,0,
4406,41740,"San Diego-Carlsbad-San Marcos, CA Metro Area",Rail,2005,3,138,141,0,
4407,41740,"San Diego-Carlsbad-San Marcos, CA Metro Area",Rail,2006,0,196,196,0,
4408,41740,"San Diego-Carlsbad-San Marcos, CA Metro Area",Rail,2007,35,409,444,0,
4409,41740,"San Diego-Carlsbad-San Marcos, CA Metro Area",Rail,2008,19,492,511,0,
4410,41740,"San Diego-Carlsbad-San Marcos, CA Metro Area",Rail,2009,31,558,589,0,
4411,41740,"San Diego-Carlsbad-San Marcos, CA Metro Area",Rail,2010,35,729,764,0,
4412,41740,"San Diego-Carlsbad-San Marcos, CA Metro Area",Rail,2011,32,681,713,0,
4413,41740,"San Diego-Carlsbad-San Marcos, CA Metro Area",Rail,2012,31,3336,3367,0,
4414,41740,"San Diego-Carlsbad-San Marcos, CA Metro Area",Rail,2013,36,1744,1780,0,
4415,41740,"San Diego-Carlsbad-San Marcos, CA Metro Area",Rail,2014,36,1561,1597,0,
4416,41740,"San Diego-Carlsbad-San Marcos, CA Metro Area",Rail,2015,422,1101,1523,0,
4417,41740,"San Diego-Carlsbad-San Marcos, CA Metro Area",Rail,2016,491,946,1437,0,
4418,41740,"San Diego-Carlsbad-San Marcos, CA Metro Area",Rail,2017,542,1009,1551,0,
4419,41740,"San Diego-Carlsbad-San Marcos, CA Metro Area",Rail,2018,583,606,1189,0,
187,41860,"San Francisco-Oakland-Fremont, CA Metro Area",Bus,2002,0,0,0,0,
1173,41860,"San Francisco-Oakland-Fremont, CA Metro Area",Bus,2002,249,145,394,0,
4420,41860,"San Francisco-Oakland-Fremont, CA Metro Area",Bus,2002,12452,5641,18093,0,
188,41860,"San Francisco-Oakland-Fremont, CA Metro Area",Bus,2003,0,0,0,0,
1174,41860,"San Francisco-Oakland-Fremont, CA Metro Area",Bus,2003,191,86,277,0,
4421,41860,"San Francisco-Oakland-Fremont, CA Metro Area",Bus,2003,12231,6278,18509,0,
189,41860,"San Francisco-Oakland-Fremont, CA Metro Area",Bus,2004,0,0,0,0,
1175,41860,"San Francisco-Oakland-Fremont, CA Metro Area",Bus,2004,168,87,255,0,
4422,41860,"San Francisco-Oakland-Fremont, CA Metro Area",Bus,2004,9183,6050,15233,0,
190,41860,"San Francisco-Oakland-Fremont, CA Metro Area",Bus,2005,0,0,0,0,
1176,41860,"San Francisco-Oakland-Fremont, CA Metro Area",Bus,2005,166,83,249,0,
4423,41860,"San Francisco-Oakland-Fremont, CA Metro Area",Bus,2005,9444,6456,15900,0,
191,41860,"San Francisco-Oakland-Fremont, CA Metro Area",Bus,2006,0,0,0,0,
1177,41860,"San Francisco-Oakland-Fremont, CA Metro Area",Bus,2006,154,85,239,0,
4424,41860,"San Francisco-Oakland-Fremont, CA Metro Area",Bus,2006,9921,5221,15142,0,
192,41860,"San Francisco-Oakland-Fremont, CA Metro Area",Bus,2007,0,0,0,0,
1178,41860,"San Francisco-Oakland-Fremont, CA Metro Area",Bus,2007,182,63,245,0,
4425,41860,"San Francisco-Oakland-Fremont, CA Metro Area",Bus,2007,8689,6127,14816,0,
193,41860,"San Francisco-Oakland-Fremont, CA Metro Area",Bus,2008,83,0,83,0,
1179,41860,"San Francisco-Oakland-Fremont, CA Metro Area",Bus,2008,171,80,251,0,
4426,41860,"San Francisco-Oakland-Fremont, CA Metro Area",Bus,2008,9525,7962,17487,0,
194,41860,"San Francisco-Oakland-Fremont, CA Metro Area",Bus,2009,81,113,194,0,
1180,41860,"San Francisco-Oakland-Fremont, CA Metro Area",Bus,2009,379,321,700,0,
4427,41860,"San Francisco-Oakland-Fremont, CA Metro Area",Bus,2009,8889,8377,17266,0,
195,41860,"San Francisco-Oakland-Fremont, CA Metro Area",Bus,2010,62,78,140,0,
1181,41860,"San Francisco-Oakland-Fremont, CA Metro Area",Bus,2010,362,159,521,0,
4428,41860,"San Francisco-Oakland-Fremont, CA Metro Area",Bus,2010,8613,6649,15262,0,
196,41860,"San Francisco-Oakland-Fremont, CA Metro Area",Bus,2011,30,38,68,0,
1182,41860,"San Francisco-Oakland-Fremont, CA Metro Area",Bus,2011,290,170,460,0,
4429,41860,"San Francisco-Oakland-Fremont, CA Metro Area",Bus,2011,5404,5546,10950,0,
197,41860,"San Francisco-Oakland-Fremont, CA Metro Area",Bus,2012,78,38,116,0,
1183,41860,"San Francisco-Oakland-Fremont, CA Metro Area",Bus,2012,172,98,270,0,
4430,41860,"San Francisco-Oakland-Fremont, CA Metro Area",Bus,2012,8074,2795,10869,0,
198,41860,"San Francisco-Oakland-Fremont, CA Metro Area",Bus,2013,30,136,166,0,
1184,41860,"San Francisco-Oakland-Fremont, CA Metro Area",Bus,2013,202,71,273,0,
4431,41860,"San Francisco-Oakland-Fremont, CA Metro Area",Bus,2013,7177,2424,9601,0,
199,41860,"San Francisco-Oakland-Fremont, CA Metro Area",Bus,2014,16,186,202,0,
1185,41860,"San Francisco-Oakland-Fremont, CA Metro Area",Bus,2014,240,104,344,0,
4432,41860,"San Francisco-Oakland-Fremont, CA Metro Area",Bus,2014,6667,2291,8958,0,
200,41860,"San Francisco-Oakland-Fremont, CA Metro Area",Bus,2015,59,23,82,0,
1186,41860,"San Francisco-Oakland-Fremont, CA Metro Area",Bus,2015,181,91,272,0,
4433,41860,"San Francisco-Oakland-Fremont, CA Metro Area",Bus,2015,6502,2043,8545,0,
201,41860,"San Francisco-Oakland-Fremont, CA Metro Area",Bus,2016,88,38,126,0,
1187,41860,"San Francisco-Oakland-Fremont, CA Metro Area",Bus,2016,197,68,265,0,
4434,41860,"San Francisco-Oakland-Fremont, CA Metro Area",Bus,2016,6449,2235,8684,0,
202,41860,"San Francisco-Oakland-Fremont, CA Metro Area",Bus,2017,117,40,157,0,
1188,41860,"San Francisco-Oakland-Fremont, CA Metro Area",Bus,2017,190,59,249,0,
4435,41860,"San Francisco-Oakland-Fremont, CA Metro Area",Bus,2017,5580,2988,8568,0,
203,41860,"San Francisco-Oakland-Fremont, CA Metro Area",Bus,2018,124,18,142,0,
1189,41860,"San Francisco-Oakland-Fremont, CA Metro Area",Bus,2018,217,80,297,0,
4436,41860,"San Francisco-Oakland-Fremont, CA Metro Area",Bus,2018,5798,2010,7808,0,
4437,41860,"San Francisco-Oakland-Fremont, CA Metro Area",Rail,2002,3412,318,3730,0,
4438,41860,"San Francisco-Oakland-Fremont, CA Metro Area",Rail,2003,2804,347,3151,0,
4439,41860,"San Francisco-Oakland-Fremont, CA Metro Area",Rail,2004,3182,446,3628,0,
4440,41860,"San Francisco-Oakland-Fremont, CA Metro Area",Rail,2005,3017,400,3417,0,
4441,41860,"San Francisco-Oakland-Fremont, CA Metro Area",Rail,2006,3286,423,3709,0,
4442,41860,"San Francisco-Oakland-Fremont, CA Metro Area",Rail,2007,3386,1103,4489,0,
4443,41860,"San Francisco-Oakland-Fremont, CA Metro Area",Rail,2008,1445,3696,5141,0,
4444,41860,"San Francisco-Oakland-Fremont, CA Metro Area",Rail,2009,2747,9057,11804,0,
4445,41860,"San Francisco-Oakland-Fremont, CA Metro Area",Rail,2010,2884,7797,10681,0,
4446,41860,"San Francisco-Oakland-Fremont, CA Metro Area",Rail,2011,2939,8147,11086,0,
4447,41860,"San Francisco-Oakland-Fremont, CA Metro Area",Rail,2012,1991,7959,9950,0,
4448,41860,"San Francisco-Oakland-Fremont, CA Metro Area",Rail,2013,1863,8801,10664,0,
4449,41860,"San Francisco-Oakland-Fremont, CA Metro Area",Rail,2014,2102,8436,10538,0,
4450,41860,"San Francisco-Oakland-Fremont, CA Metro Area",Rail,2015,1664,8436,10100,0,
4451,41860,"San Francisco-Oakland-Fremont, CA Metro Area",Rail,2016,1474,7463,8937,0,
4452,41860,"San Francisco-Oakland-Fremont, CA Metro Area",Rail,2017,1542,4772,6314,0,
4453,41860,"San Francisco-Oakland-Fremont, CA Metro Area",Rail,2018,1784,3097,4881,0,
4454,41940,"San Jose-Sunnyvale-Santa Clara, CA Metro Area",Bus,2002,5582,1320,6902,0,
4455,41940,"San Jose-Sunnyvale-Santa Clara, CA Metro Area",Bus,2003,4067,1004,5071,0,
4456,41940,"San Jose-Sunnyvale-Santa Clara, CA Metro Area",Bus,2004,3016,542,3558,0,
4457,41940,"San Jose-Sunnyvale-Santa Clara, CA Metro Area",Bus,2005,2917,597,3514,0,
4458,41940,"San Jose-Sunnyvale-Santa Clara, CA Metro Area",Bus,2006,3430,751,4181,0,
4459,41940,"San Jose-Sunnyvale-Santa Clara, CA Metro Area",Bus,2007,3346,716,4062,0,
4460,41940,"San Jose-Sunnyvale-Santa Clara, CA Metro Area",Bus,2008,2498,651,3149,0,
4461,41940,"San Jose-Sunnyvale-Santa Clara, CA Metro Area",Bus,2009,2232,610,2842,0,
4462,41940,"San Jose-Sunnyvale-Santa Clara, CA Metro Area",Bus,2010,2053,485,2538,0,
4463,41940,"San Jose-Sunnyvale-Santa Clara, CA Metro Area",Bus,2011,1733,428,2161,0,
4464,41940,"San Jose-Sunnyvale-Santa Clara, CA Metro Area",Bus,2012,1677,346,2023,0,
4465,41940,"San Jose-Sunnyvale-Santa Clara, CA Metro Area",Bus,2013,1450,299,1749,0,
4466,41940,"San Jose-Sunnyvale-Santa Clara, CA Metro Area",Bus,2014,1792,435,2227,0,
4467,41940,"San Jose-Sunnyvale-Santa Clara, CA Metro Area",Bus,2015,1865,366,2231,0,
4468,41940,"San Jose-Sunnyvale-Santa Clara, CA Metro Area",Bus,2016,1899,302,2201,0,
4469,41940,"San Jose-Sunnyvale-Santa Clara, CA Metro Area",Bus,2017,1785,372,2157,0,
4470,41940,"San Jose-Sunnyvale-Santa Clara, CA Metro Area",Bus,2018,1620,321,1941,0,
4471,41940,"San Jose-Sunnyvale-Santa Clara, CA Metro Area",Rail,2002,96,2,98,0,
4472,41940,"San Jose-Sunnyvale-Santa Clara, CA Metro Area",Rail,2003,53,0,53,0,
4473,41940,"San Jose-Sunnyvale-Santa Clara, CA Metro Area",Rail,2004,86,0,86,0,
4474,41940,"San Jose-Sunnyvale-Santa Clara, CA Metro Area",Rail,2005,72,0,72,0,
4475,41940,"San Jose-Sunnyvale-Santa Clara, CA Metro Area",Rail,2006,80,3,83,0,
4476,41940,"San Jose-Sunnyvale-Santa Clara, CA Metro Area",Rail,2007,86,0,86,0,
4477,41940,"San Jose-Sunnyvale-Santa Clara, CA Metro Area",Rail,2008,78,2,80,0,
4478,41940,"San Jose-Sunnyvale-Santa Clara, CA Metro Area",Rail,2009,58,8,66,0,
4479,41940,"San Jose-Sunnyvale-Santa Clara, CA Metro Area",Rail,2010,50,4,54,0,
4480,41940,"San Jose-Sunnyvale-Santa Clara, CA Metro Area",Rail,2011,55,7,62,0,
4481,41940,"San Jose-Sunnyvale-Santa Clara, CA Metro Area",Rail,2012,67,2,69,0,
4482,41940,"San Jose-Sunnyvale-Santa Clara, CA Metro Area",Rail,2013,54,0,54,0,
4483,41940,"San Jose-Sunnyvale-Santa Clara, CA Metro Area",Rail,2014,59,0,59,0,
4484,41940,"San Jose-Sunnyvale-Santa Clara, CA Metro Area",Rail,2015,110,0,110,0,
4485,41940,"San Jose-Sunnyvale-Santa Clara, CA Metro Area",Rail,2016,95,0,95,0,
4486,41940,"San Jose-Sunnyvale-Santa Clara, CA Metro Area",Rail,2017,84,0,84,0,
4487,41940,"San Jose-Sunnyvale-Santa Clara, CA Metro Area",Rail,2018,90,0,90,0,
4488,42060,"Santa Barbara-Santa Maria-Goleta, CA Metro Area",Bus,2002,223,85,308,0,
4556,42060,"Santa Barbara-Santa Maria-Goleta, CA Metro Area",Bus,2002,0,0,0,0,
4489,42060,"Santa Barbara-Santa Maria-Goleta, CA Metro Area",Bus,2003,260,100,360,0,
4557,42060,"Santa Barbara-Santa Maria-Goleta, CA Metro Area",Bus,2003,0,0,0,0,
4490,42060,"Santa Barbara-Santa Maria-Goleta, CA Metro Area",Bus,2004,383,231,614,0,
4558,42060,"Santa Barbara-Santa Maria-Goleta, CA Metro Area",Bus,2004,0,0,0,0,
4491,42060,"Santa Barbara-Santa Maria-Goleta, CA Metro Area",Bus,2005,208,173,381,0,
4559,42060,"Santa Barbara-Santa Maria-Goleta, CA Metro Area",Bus,2005,0,0,0,0,
4492,42060,"Santa Barbara-Santa Maria-Goleta, CA Metro Area",Bus,2006,228,190,418,0,
4560,42060,"Santa Barbara-Santa Maria-Goleta, CA Metro Area",Bus,2006,0,0,0,0,
4493,42060,"Santa Barbara-Santa Maria-Goleta, CA Metro Area",Bus,2007,316,107,423,0,
4561,42060,"Santa Barbara-Santa Maria-Goleta, CA Metro Area",Bus,2007,0,0,0,0,
4494,42060,"Santa Barbara-Santa Maria-Goleta, CA Metro Area",Bus,2008,315,74,389,0,
4562,42060,"Santa Barbara-Santa Maria-Goleta, CA Metro Area",Bus,2008,19,3,22,0,
4495,42060,"Santa Barbara-Santa Maria-Goleta, CA Metro Area",Bus,2009,180,43,223,0,
4563,42060,"Santa Barbara-Santa Maria-Goleta, CA Metro Area",Bus,2009,28,43,71,0,
4496,42060,"Santa Barbara-Santa Maria-Goleta, CA Metro Area",Bus,2010,334,131,465,0,
4564,42060,"Santa Barbara-Santa Maria-Goleta, CA Metro Area",Bus,2010,46,8,54,0,
4497,42060,"Santa Barbara-Santa Maria-Goleta, CA Metro Area",Bus,2011,365,390,755,0,
4565,42060,"Santa Barbara-Santa Maria-Goleta, CA Metro Area",Bus,2011,52,17,69,0,
4498,42060,"Santa Barbara-Santa Maria-Goleta, CA Metro Area",Bus,2012,532,143,675,0,
4566,42060,"Santa Barbara-Santa Maria-Goleta, CA Metro Area",Bus,2012,42,10,52,0,
4499,42060,"Santa Barbara-Santa Maria-Goleta, CA Metro Area",Bus,2013,427,107,534,0,
4567,42060,"Santa Barbara-Santa Maria-Goleta, CA Metro Area",Bus,2013,53,10,63,0,
4500,42060,"Santa Barbara-Santa Maria-Goleta, CA Metro Area",Bus,2014,351,133,484,0,
4568,42060,"Santa Barbara-Santa Maria-Goleta, CA Metro Area",Bus,2014,29,0,29,0,
4501,42060,"Santa Barbara-Santa Maria-Goleta, CA Metro Area",Bus,2015,386,189,575,0,
4569,42060,"Santa Barbara-Santa Maria-Goleta, CA Metro Area",Bus,2015,34,0,34,0,
4502,42060,"Santa Barbara-Santa Maria-Goleta, CA Metro Area",Bus,2016,411,216,627,0,
4570,42060,"Santa Barbara-Santa Maria-Goleta, CA Metro Area",Bus,2016,34,0,34,0,
4503,42060,"Santa Barbara-Santa Maria-Goleta, CA Metro Area",Bus,2017,44,388,432,0,
4571,42060,"Santa Barbara-Santa Maria-Goleta, CA Metro Area",Bus,2017,17,0,17,0,
4504,42060,"Santa Barbara-Santa Maria-Goleta, CA Metro Area",Bus,2018,74,376,450,0,
4572,42060,"Santa Barbara-Santa Maria-Goleta, CA Metro Area",Bus,2018,16,0,16,0,
4522,42100,"Santa Cruz-Watsonville, CA Metro Area",Bus,2002,116,153,269,0,
4523,42100,"Santa Cruz-Watsonville, CA Metro Area",Bus,2003,64,122,186,0,
4524,42100,"Santa Cruz-Watsonville, CA Metro Area",Bus,2004,116,246,362,0,
4525,42100,"Santa Cruz-Watsonville, CA Metro Area",Bus,2005,163,181,344,0,
4526,42100,"Santa Cruz-Watsonville, CA Metro Area",Bus,2006,96,185,281,0,
4527,42100,"Santa Cruz-Watsonville, CA Metro Area",Bus,2007,78,208,286,0,
4528,42100,"Santa Cruz-Watsonville, CA Metro Area",Bus,2008,131,202,333,0,
4529,42100,"Santa Cruz-Watsonville, CA Metro Area",Bus,2009,230,29,259,0,
4530,42100,"Santa Cruz-Watsonville, CA Metro Area",Bus,2010,199,9,208,0,
4531,42100,"Santa Cruz-Watsonville, CA Metro Area",Bus,2011,295,6,301,0,
4532,42100,"Santa Cruz-Watsonville, CA Metro Area",Bus,2012,261,37,298,0,
4533,42100,"Santa Cruz-Watsonville, CA Metro Area",Bus,2013,263,46,309,0,
4534,42100,"Santa Cruz-Watsonville, CA Metro Area",Bus,2014,209,69,278,0,
4535,42100,"Santa Cruz-Watsonville, CA Metro Area",Bus,2015,140,54,194,0,
4536,42100,"Santa Cruz-Watsonville, CA Metro Area",Bus,2016,30,159,189,0,
4537,42100,"Santa Cruz-Watsonville, CA Metro Area",Bus,2017,29,248,277,0,
4538,42100,"Santa Cruz-Watsonville, CA Metro Area",Bus,2018,285,14,299,0,
4539,42140,"Santa Fe, NM Metro Area",Bus,2002,112,156,268,0,
4540,42140,"Santa Fe, NM Metro Area",Bus,2003,199,36,235,0,
4541,42140,"Santa Fe, NM Metro Area",Bus,2004,284,111,395,0,
4542,42140,"Santa Fe, NM Metro Area",Bus,2005,290,828,1118,0,
4543,42140,"Santa Fe, NM Metro Area",Bus,2006,275,1130,1405,0,
4544,42140,"Santa Fe, NM Metro Area",Bus,2007,389,935,1324,0,
4545,42140,"Santa Fe, NM Metro Area",Bus,2008,2385,1215,3600,0,
4546,42140,"Santa Fe, NM Metro Area",Bus,2009,1013,878,1891,0,
4547,42140,"Santa Fe, NM Metro Area",Bus,2010,216,803,1019,0,
4548,42140,"Santa Fe, NM Metro Area",Bus,2011,115,545,660,0,
4549,42140,"Santa Fe, NM Metro Area",Bus,2012,23,92,115,0,
4550,42140,"Santa Fe, NM Metro Area",Bus,2013,33,79,112,0,
4551,42140,"Santa Fe, NM Metro Area",Bus,2014,43,14,57,0,
4552,42140,"Santa Fe, NM Metro Area",Bus,2015,13,31,44,0,
4553,42140,"Santa Fe, NM Metro Area",Bus,2016,15,37,52,0,
4554,42140,"Santa Fe, NM Metro Area",Bus,2017,12,35,47,0,
4555,42140,"Santa Fe, NM Metro Area",Bus,2018,17,42,59,0,
3723,42220,"Santa Rosa-Petaluma, CA Metro Area",Bus,2002,0,0,0,0,
4573,42220,"Santa Rosa-Petaluma, CA Metro Area",Bus,2002,13,0,13,0,
3724,42220,"Santa Rosa-Petaluma, CA Metro Area",Bus,2003,0,0,0,0,
4574,42220,"Santa Rosa-Petaluma, CA Metro Area",Bus,2003,8,0,8,0,
3725,42220,"Santa Rosa-Petaluma, CA Metro Area",Bus,2004,0,0,0,0,
4575,42220,"Santa Rosa-Petaluma, CA Metro Area",Bus,2004,2,0,2,0,
3726,42220,"Santa Rosa-Petaluma, CA Metro Area",Bus,2005,0,0,0,0,
4576,42220,"Santa Rosa-Petaluma, CA Metro Area",Bus,2005,5,0,5,0,
3727,42220,"Santa Rosa-Petaluma, CA Metro Area",Bus,2006,0,0,0,0,
4577,42220,"Santa Rosa-Petaluma, CA Metro Area",Bus,2006,4,0,4,0,
3728,42220,"Santa Rosa-Petaluma, CA Metro Area",Bus,2007,0,0,0,0,
4578,42220,"Santa Rosa-Petaluma, CA Metro Area",Bus,2007,9,0,9,0,
3729,42220,"Santa Rosa-Petaluma, CA Metro Area",Bus,2008,10,0,10,0,
4579,42220,"Santa Rosa-Petaluma, CA Metro Area",Bus,2008,103,86,189,0,
3730,42220,"Santa Rosa-Petaluma, CA Metro Area",Bus,2009,2,0,2,0,
4580,42220,"Santa Rosa-Petaluma, CA Metro Area",Bus,2009,283,270,553,0,
3731,42220,"Santa Rosa-Petaluma, CA Metro Area",Bus,2010,1,2,3,0,
4581,42220,"Santa Rosa-Petaluma, CA Metro Area",Bus,2010,176,223,399,0,
3732,42220,"Santa Rosa-Petaluma, CA Metro Area",Bus,2011,3,0,3,0,
4582,42220,"Santa Rosa-Petaluma, CA Metro Area",Bus,2011,131,187,318,0,
3733,42220,"Santa Rosa-Petaluma, CA Metro Area",Bus,2012,0,0,0,0,
4583,42220,"Santa Rosa-Petaluma, CA Metro Area",Bus,2012,108,183,291,0,
3734,42220,"Santa Rosa-Petaluma, CA Metro Area",Bus,2013,7,0,7,0,
4584,42220,"Santa Rosa-Petaluma, CA Metro Area",Bus,2013,97,330,427,0,
3735,42220,"Santa Rosa-Petaluma, CA Metro Area",Bus,2014,4,0,4,0,
4585,42220,"Santa Rosa-Petaluma, CA Metro Area",Bus,2014,113,282,395,0,
3736,42220,"Santa Rosa-Petaluma, CA Metro Area",Bus,2015,2,5,7,0,
4586,42220,"Santa Rosa-Petaluma, CA Metro Area",Bus,2015,70,240,310,0,
3737,42220,"Santa Rosa-Petaluma, CA Metro Area",Bus,2016,10,0,10,0,
4587,42220,"Santa Rosa-Petaluma, CA Metro Area",Bus,2016,97,69,166,0,
3738,42220,"Santa Rosa-Petaluma, CA Metro Area",Bus,2017,6,11,17,0,
4588,42220,"Santa Rosa-Petaluma, CA Metro Area",Bus,2017,87,30,117,0,
3739,42220,"Santa Rosa-Petaluma, CA Metro Area",Bus,2018,7,3,10,0,
4589,42220,"Santa Rosa-Petaluma, CA Metro Area",Bus,2018,126,37,163,0,
4590,42340,"Savannah, GA Metro Area",Bus,2002,521,373,894,0,
4591,42340,"Savannah, GA Metro Area",Bus,2003,524,182,706,0,
4592,42340,"Savannah, GA Metro Area",Bus,2004,425,459,884,0,
4593,42340,"Savannah, GA Metro Area",Bus,2005,382,442,824,0,
4594,42340,"Savannah, GA Metro Area",Bus,2006,392,430,822,0,
4595,42340,"Savannah, GA Metro Area",Bus,2007,412,445,857,0,
4596,42340,"Savannah, GA Metro Area",Bus,2008,308,445,753,0,
4597,42340,"Savannah, GA Metro Area",Bus,2009,385,123,508,0,
4598,42340,"Savannah, GA Metro Area",Bus,2010,312,126,438,0,
4599,42340,"Savannah, GA Metro Area",Bus,2011,335,114,449,0,
4600,42340,"Savannah, GA Metro Area",Bus,2012,284,105,389,0,
4601,42340,"Savannah, GA Metro Area",Bus,2013,249,98,347,0,
4602,42340,"Savannah, GA Metro Area",Bus,2014,133,40,173,0,
4603,42340,"Savannah, GA Metro Area",Bus,2015,147,62,209,0,
4604,42340,"Savannah, GA Metro Area",Bus,2016,242,58,300,0,
4605,42340,"Savannah, GA Metro Area",Bus,2017,272,56,328,0,
4606,42340,"Savannah, GA Metro Area",Bus,2018,262,58,320,0,
4607,42540,"Scranton--Wilkes-Barre, PA Metro Area",Bus,2002,286,173,459,0,
4608,42540,"Scranton--Wilkes-Barre, PA Metro Area",Bus,2003,305,210,515,0,
4609,42540,"Scranton--Wilkes-Barre, PA Metro Area",Bus,2004,341,243,584,0,
4610,42540,"Scranton--Wilkes-Barre, PA Metro Area",Bus,2005,260,192,452,0,
4611,42540,"Scranton--Wilkes-Barre, PA Metro Area",Bus,2006,203,403,606,0,
4612,42540,"Scranton--Wilkes-Barre, PA Metro Area",Bus,2007,219,494,713,0,
4613,42540,"Scranton--Wilkes-Barre, PA Metro Area",Bus,2008,265,616,881,0,
4614,42540,"Scranton--Wilkes-Barre, PA Metro Area",Bus,2009,338,685,1023,0,
4615,42540,"Scranton--Wilkes-Barre, PA Metro Area",Bus,2010,345,1039,1384,0,
4616,42540,"Scranton--Wilkes-Barre, PA Metro Area",Bus,2011,356,1153,1509,0,
4617,42540,"Scranton--Wilkes-Barre, PA Metro Area",Bus,2012,340,1141,1481,0,
4618,42540,"Scranton--Wilkes-Barre, PA Metro Area",Bus,2013,255,2600,2855,0,
4619,42540,"Scranton--Wilkes-Barre, PA Metro Area",Bus,2014,215,1344,1559,0,
4620,42540,"Scranton--Wilkes-Barre, PA Metro Area",Bus,2015,214,1148,1362,0,
4621,42540,"Scranton--Wilkes-Barre, PA Metro Area",Bus,2016,251,1020,1271,0,
4622,42540,"Scranton--Wilkes-Barre, PA Metro Area",Bus,2017,158,643,801,0,
4623,42540,"Scranton--Wilkes-Barre, PA Metro Area",Bus,2018,158,254,412,0,
4641,42660,"Seattle-Tacoma-Bellevue, WA Metro Area",Bus,2002,11418,776,12194,0,
4642,42660,"Seattle-Tacoma-Bellevue, WA Metro Area",Bus,2003,2297,534,2831,0,
4643,42660,"Seattle-Tacoma-Bellevue, WA Metro Area",Bus,2004,2434,419,2853,0,
4644,42660,"Seattle-Tacoma-Bellevue, WA Metro Area",Bus,2005,2036,361,2397,0,
4645,42660,"Seattle-Tacoma-Bellevue, WA Metro Area",Bus,2006,10424,6332,16756,0,
4646,42660,"Seattle-Tacoma-Bellevue, WA Metro Area",Bus,2007,10087,7653,17740,0,
4647,42660,"Seattle-Tacoma-Bellevue, WA Metro Area",Bus,2008,9622,8459,18081,0,
4648,42660,"Seattle-Tacoma-Bellevue, WA Metro Area",Bus,2009,10113,7653,17766,0,
4649,42660,"Seattle-Tacoma-Bellevue, WA Metro Area",Bus,2010,9814,12381,22195,0,
4650,42660,"Seattle-Tacoma-Bellevue, WA Metro Area",Bus,2011,10187,14578,24765,0,
4651,42660,"Seattle-Tacoma-Bellevue, WA Metro Area",Bus,2012,10824,14375,25199,0,
4652,42660,"Seattle-Tacoma-Bellevue, WA Metro Area",Bus,2013,11087,11957,23044,0,
4653,42660,"Seattle-Tacoma-Bellevue, WA Metro Area",Bus,2014,10512,11278,21790,0,
4654,42660,"Seattle-Tacoma-Bellevue, WA Metro Area",Bus,2015,11173,12194,23367,0,
4655,42660,"Seattle-Tacoma-Bellevue, WA Metro Area",Bus,2016,12207,11572,23779,0,
4656,42660,"Seattle-Tacoma-Bellevue, WA Metro Area",Bus,2017,12612,12899,25511,0,
4657,42660,"Seattle-Tacoma-Bellevue, WA Metro Area",Bus,2018,12006,12801,24807,0,
4658,42660,"Seattle-Tacoma-Bellevue, WA Metro Area",Rail,2002,0,0,0,1,
4659,42660,"Seattle-Tacoma-Bellevue, WA Metro Area",Rail,2003,0,0,0,1,
4660,42660,"Seattle-Tacoma-Bellevue, WA Metro Area",Rail,2004,0,0,0,1,
4661,42660,"Seattle-Tacoma-Bellevue, WA Metro Area",Rail,2005,2,0,2,1,
4662,42660,"Seattle-Tacoma-Bellevue, WA Metro Area",Rail,2006,0,1,1,1,
4663,42660,"Seattle-Tacoma-Bellevue, WA Metro Area",Rail,2007,0,0,0,1,
4664,42660,"Seattle-Tacoma-Bellevue, WA Metro Area",Rail,2008,9,1,10,1,
4665,42660,"Seattle-Tacoma-Bellevue, WA Metro Area",Rail,2009,93,5,98,0,
4666,42660,"Seattle-Tacoma-Bellevue, WA Metro Area",Rail,2010,100,4,104,0,
4667,42660,"Seattle-Tacoma-Bellevue, WA Metro Area",Rail,2011,101,6,107,0,
4668,42660,"Seattle-Tacoma-Bellevue, WA Metro Area",Rail,2012,138,3,141,0,
4669,42660,"Seattle-Tacoma-Bellevue, WA Metro Area",Rail,2013,110,28,138,0,
4670,42660,"Seattle-Tacoma-Bellevue, WA Metro Area",Rail,2014,104,17,121,0,
4671,42660,"Seattle-Tacoma-Bellevue, WA Metro Area",Rail,2015,116,23,139,0,
4672,42660,"Seattle-Tacoma-Bellevue, WA Metro Area",Rail,2016,148,124,272,0,
4673,42660,"Seattle-Tacoma-Bellevue, WA Metro Area",Rail,2017,130,72,202,0,
4674,42660,"Seattle-Tacoma-Bellevue, WA Metro Area",Rail,2018,131,45,176,0,
4675,42680,"Sebastian-Vero Beach, FL Metro Area",Bus,2002,1,1,2,0,
4676,42680,"Sebastian-Vero Beach, FL Metro Area",Bus,2003,0,2,2,0,
4677,42680,"Sebastian-Vero Beach, FL Metro Area",Bus,2004,0,2,2,0,
4678,42680,"Sebastian-Vero Beach, FL Metro Area",Bus,2005,0,0,0,0,
4679,42680,"Sebastian-Vero Beach, FL Metro Area",Bus,2006,0,1,1,0,
4680,42680,"Sebastian-Vero Beach, FL Metro Area",Bus,2007,0,1,1,0,
4681,42680,"Sebastian-Vero Beach, FL Metro Area",Bus,2008,4,5,9,0,
4682,42680,"Sebastian-Vero Beach, FL Metro Area",Bus,2009,9,11,20,0,
4683,42680,"Sebastian-Vero Beach, FL Metro Area",Bus,2010,7,12,19,0,
4684,42680,"Sebastian-Vero Beach, FL Metro Area",Bus,2011,20,22,42,0,
4685,42680,"Sebastian-Vero Beach, FL Metro Area",Bus,2012,2,5,7,0,
4686,42680,"Sebastian-Vero Beach, FL Metro Area",Bus,2013,16,32,48,0,
4687,42680,"Sebastian-Vero Beach, FL Metro Area",Bus,2014,2,12,14,0,
4688,42680,"Sebastian-Vero Beach, FL Metro Area",Bus,2015,0,5,5,0,
4689,42680,"Sebastian-Vero Beach, FL Metro Area",Bus,2016,2,5,7,0,
4690,42680,"Sebastian-Vero Beach, FL Metro Area",Bus,2017,2,11,13,0,
4691,42680,"Sebastian-Vero Beach, FL Metro Area",Bus,2018,5,9,14,0,
4692,43340,"Shreveport-Bossier City, LA Metro Area",Bus,2002,231,67,298,0,
4693,43340,"Shreveport-Bossier City, LA Metro Area",Bus,2003,220,50,270,0,
4694,43340,"Shreveport-Bossier City, LA Metro Area",Bus,2004,280,45,325,0,
4695,43340,"Shreveport-Bossier City, LA Metro Area",Bus,2005,263,32,295,0,
4696,43340,"Shreveport-Bossier City, LA Metro Area",Bus,2006,291,30,321,0,
4697,43340,"Shreveport-Bossier City, LA Metro Area",Bus,2007,269,33,302,0,
4698,43340,"Shreveport-Bossier City, LA Metro Area",Bus,2008,212,25,237,0,
4699,43340,"Shreveport-Bossier City, LA Metro Area",Bus,2009,288,21,309,0,
4700,43340,"Shreveport-Bossier City, LA Metro Area",Bus,2010,279,23,302,0,
4701,43340,"Shreveport-Bossier City, LA Metro Area",Bus,2011,228,36,264,0,
4702,43340,"Shreveport-Bossier City, LA Metro Area",Bus,2012,256,18,274,0,
4703,43340,"Shreveport-Bossier City, LA Metro Area",Bus,2013,351,68,419,0,
4704,43340,"Shreveport-Bossier City, LA Metro Area",Bus,2014,536,183,719,0,
4705,43340,"Shreveport-Bossier City, LA Metro Area",Bus,2015,538,312,850,0,
4706,43340,"Shreveport-Bossier City, LA Metro Area",Bus,2016,247,1217,1464,0,
4707,43340,"Shreveport-Bossier City, LA Metro Area",Bus,2017,288,655,943,0,
4708,43340,"Shreveport-Bossier City, LA Metro Area",Bus,2018,333,555,888,0,
4709,43580,"Sioux City, IA-NE-SD Metro Area",Bus,2002,73,132,205,0,
4710,43580,"Sioux City, IA-NE-SD Metro Area",Bus,2003,14,185,199,0,
4711,43580,"Sioux City, IA-NE-SD Metro Area",Bus,2004,10,112,122,0,
4712,43580,"Sioux City, IA-NE-SD Metro Area",Bus,2005,18,64,82,0,
4713,43580,"Sioux City, IA-NE-SD Metro Area",Bus,2006,24,7,31,0,
4714,43580,"Sioux City, IA-NE-SD Metro Area",Bus,2007,21,4,25,0,
4715,43580,"Sioux City, IA-NE-SD Metro Area",Bus,2008,21,1,22,0,
4716,43580,"Sioux City, IA-NE-SD Metro Area",Bus,2009,17,5,22,0,
4717,43580,"Sioux City, IA-NE-SD Metro Area",Bus,2010,12,1,13,0,
4718,43580,"Sioux City, IA-NE-SD Metro Area",Bus,2011,31,15,46,0,
4719,43580,"Sioux City, IA-NE-SD Metro Area",Bus,2012,12,46,58,0,
4720,43580,"Sioux City, IA-NE-SD Metro Area",Bus,2013,60,26,86,0,
4721,43580,"Sioux City, IA-NE-SD Metro Area",Bus,2014,19,74,93,0,
4722,43580,"Sioux City, IA-NE-SD Metro Area",Bus,2015,27,86,113,0,
4723,43580,"Sioux City, IA-NE-SD Metro Area",Bus,2016,70,33,103,0,
4724,43580,"Sioux City, IA-NE-SD Metro Area",Bus,2017,125,24,149,0,
4725,43580,"Sioux City, IA-NE-SD Metro Area",Bus,2018,93,82,175,0,
4726,43620,"Sioux Falls, SD Metro Area",Bus,2002,4,50,54,0,
4727,43620,"Sioux Falls, SD Metro Area",Bus,2003,33,16,49,0,
4728,43620,"Sioux Falls, SD Metro Area",Bus,2004,27,4,31,0,
4729,43620,"Sioux Falls, SD Metro Area",Bus,2005,50,1,51,0,
4730,43620,"Sioux Falls, SD Metro Area",Bus,2006,0,0,0,1,
4731,43620,"Sioux Falls, SD Metro Area",Bus,2007,0,0,0,1,
4732,43620,"Sioux Falls, SD Metro Area",Bus,2008,190,18,208,0,
4733,43620,"Sioux Falls, SD Metro Area",Bus,2009,102,38,140,0,
4734,43620,"Sioux Falls, SD Metro Area",Bus,2010,18,37,55,0,
4735,43620,"Sioux Falls, SD Metro Area",Bus,2011,22,33,55,0,
4736,43620,"Sioux Falls, SD Metro Area",Bus,2012,15,51,66,0,
4737,43620,"Sioux Falls, SD Metro Area",Bus,2013,17,53,70,0,
4738,43620,"Sioux Falls, SD Metro Area",Bus,2014,17,47,64,0,
4739,43620,"Sioux Falls, SD Metro Area",Bus,2015,28,47,75,0,
4740,43620,"Sioux Falls, SD Metro Area",Bus,2016,29,41,70,0,
4741,43620,"Sioux Falls, SD Metro Area",Bus,2017,29,9,38,0,
4742,43620,"Sioux Falls, SD Metro Area",Bus,2018,46,15,61,0,
4744,43780,"South Bend-Mishawaka, IN-MI Metro Area",Bus,2002,108,57,165,0,
4746,43780,"South Bend-Mishawaka, IN-MI Metro Area",Bus,2003,40,26,66,0,
4748,43780,"South Bend-Mishawaka, IN-MI Metro Area",Bus,2004,39,7,46,0,
4750,43780,"South Bend-Mishawaka, IN-MI Metro Area",Bus,2005,113,23,136,0,
4752,43780,"South Bend-Mishawaka, IN-MI Metro Area",Bus,2006,51,16,67,0,
4754,43780,"South Bend-Mishawaka, IN-MI Metro Area",Bus,2007,85,24,109,0,
4756,43780,"South Bend-Mishawaka, IN-MI Metro Area",Bus,2008,128,16,144,0,
4758,43780,"South Bend-Mishawaka, IN-MI Metro Area",Bus,2009,130,24,154,0,
4760,43780,"South Bend-Mishawaka, IN-MI Metro Area",Bus,2010,204,26,230,0,
4762,43780,"South Bend-Mishawaka, IN-MI Metro Area",Bus,2011,106,6,112,0,
4764,43780,"South Bend-Mishawaka, IN-MI Metro Area",Bus,2012,139,8,147,0,
4766,43780,"South Bend-Mishawaka, IN-MI Metro Area",Bus,2013,144,9,153,0,
4768,43780,"South Bend-Mishawaka, IN-MI Metro Area",Bus,2014,113,9,122,0,
4770,43780,"South Bend-Mishawaka, IN-MI Metro Area",Bus,2015,137,13,150,0,
4772,43780,"South Bend-Mishawaka, IN-MI Metro Area",Bus,2016,127,26,153,0,
4774,43780,"South Bend-Mishawaka, IN-MI Metro Area",Bus,2017,77,21,98,0,
4776,43780,"South Bend-Mishawaka, IN-MI Metro Area",Bus,2018,86,111,197,0,
4777,44060,"Spokane, WA Metro Area",Bus,2002,951,623,1574,0,
4778,44060,"Spokane, WA Metro Area",Bus,2003,991,665,1656,0,
4779,44060,"Spokane, WA Metro Area",Bus,2004,958,517,1475,0,
4780,44060,"Spokane, WA Metro Area",Bus,2005,733,505,1238,0,
4781,44060,"Spokane, WA Metro Area",Bus,2006,731,377,1108,0,
4782,44060,"Spokane, WA Metro Area",Bus,2007,695,410,1105,0,
4783,44060,"Spokane, WA Metro Area",Bus,2008,565,367,932,0,
4784,44060,"Spokane, WA Metro Area",Bus,2009,544,347,891,0,
4785,44060,"Spokane, WA Metro Area",Bus,2010,566,223,789,0,
4786,44060,"Spokane, WA Metro Area",Bus,2011,570,197,767,0,
4787,44060,"Spokane, WA Metro Area",Bus,2012,622,224,846,0,
4788,44060,"Spokane, WA Metro Area",Bus,2013,612,179,791,0,
4789,44060,"Spokane, WA Metro Area",Bus,2014,647,258,905,0,
4790,44060,"Spokane, WA Metro Area",Bus,2015,645,199,844,0,
4791,44060,"Spokane, WA Metro Area",Bus,2016,707,145,852,0,
4792,44060,"Spokane, WA Metro Area",Bus,2017,691,317,1008,0,
4793,44060,"Spokane, WA Metro Area",Bus,2018,689,341,1030,0,
4794,44100,"Springfield, IL Metro Area",Bus,2002,283,37,320,0,
4795,44100,"Springfield, IL Metro Area",Bus,2003,314,32,346,0,
4796,44100,"Springfield, IL Metro Area",Bus,2004,64,535,599,0,
4797,44100,"Springfield, IL Metro Area",Bus,2005,56,517,573,0,
4798,44100,"Springfield, IL Metro Area",Bus,2006,19,609,628,0,
4799,44100,"Springfield, IL Metro Area",Bus,2007,25,573,598,0,
4800,44100,"Springfield, IL Metro Area",Bus,2008,202,439,641,0,
4801,44100,"Springfield, IL Metro Area",Bus,2009,161,835,996,0,
4802,44100,"Springfield, IL Metro Area",Bus,2010,209,570,779,0,
4803,44100,"Springfield, IL Metro Area",Bus,2011,185,658,843,0,
4804,44100,"Springfield, IL Metro Area",Bus,2012,120,551,671,0,
4805,44100,"Springfield, IL Metro Area",Bus,2013,134,485,619,0,
4806,44100,"Springfield, IL Metro Area",Bus,2014,102,369,471,0,
4807,44100,"Springfield, IL Metro Area",Bus,2015,125,316,441,0,
4808,44100,"Springfield, IL Metro Area",Bus,2016,109,277,386,0,
4809,44100,"Springfield, IL Metro Area",Bus,2017,106,288,394,0,
4810,44100,"Springfield, IL Metro Area",Bus,2018,92,234,326,0,
4812,44140,"Springfield, MA Metro Area",Bus,2002,0,0,0,1,
4814,44140,"Springfield, MA Metro Area",Bus,2003,0,0,0,1,
4816,44140,"Springfield, MA Metro Area",Bus,2004,0,0,0,1,
4818,44140,"Springfield, MA Metro Area",Bus,2005,0,0,0,1,
4820,44140,"Springfield, MA Metro Area",Bus,2006,0,0,0,1,
4822,44140,"Springfield, MA Metro Area",Bus,2007,0,0,0,1,
4824,44140,"Springfield, MA Metro Area",Bus,2008,0,0,0,1,
4826,44140,"Springfield, MA Metro Area",Bus,2009,257,2717,2974,0,
4828,44140,"Springfield, MA Metro Area",Bus,2010,415,1560,1975,0,
4830,44140,"Springfield, MA Metro Area",Bus,2011,434,1733,2167,0,
4832,44140,"Springfield, MA Metro Area",Bus,2012,361,2196,2557,0,
4834,44140,"Springfield, MA Metro Area",Bus,2013,611,1834,2445,0,
4836,44140,"Springfield, MA Metro Area",Bus,2014,749,2275,3024,0,
4838,44140,"Springfield, MA Metro Area",Bus,2015,1027,2672,3699,0,
4840,44140,"Springfield, MA Metro Area",Bus,2016,900,2517,3417,0,
4842,44140,"Springfield, MA Metro Area",Bus,2017,873,2501,3374,0,
4844,44140,"Springfield, MA Metro Area",Bus,2018,1073,2899,3972,0,
4845,44180,"Springfield, MO Metro Area",Bus,2002,191,294,485,0,
4846,44180,"Springfield, MO Metro Area",Bus,2003,123,430,553,0,
4847,44180,"Springfield, MO Metro Area",Bus,2004,114,254,368,0,
4848,44180,"Springfield, MO Metro Area",Bus,2005,94,244,338,0,
4849,44180,"Springfield, MO Metro Area",Bus,2006,66,456,522,0,
4850,44180,"Springfield, MO Metro Area",Bus,2007,61,396,457,0,
4851,44180,"Springfield, MO Metro Area",Bus,2008,91,429,520,0,
4852,44180,"Springfield, MO Metro Area",Bus,2009,96,405,501,0,
4853,44180,"Springfield, MO Metro Area",Bus,2010,76,466,542,0,
4854,44180,"Springfield, MO Metro Area",Bus,2011,78,454,532,0,
4855,44180,"Springfield, MO Metro Area",Bus,2012,74,405,479,0,
4856,44180,"Springfield, MO Metro Area",Bus,2013,63,483,546,0,
4857,44180,"Springfield, MO Metro Area",Bus,2014,67,440,507,0,
4858,44180,"Springfield, MO Metro Area",Bus,2015,50,350,400,0,
4859,44180,"Springfield, MO Metro Area",Bus,2016,60,412,472,0,
4860,44180,"Springfield, MO Metro Area",Bus,2017,69,306,375,0,
4861,44180,"Springfield, MO Metro Area",Bus,2018,36,286,322,0,
4913,44300,"State College, PA Metro Area",Bus,2002,173,340,513,0,
4914,44300,"State College, PA Metro Area",Bus,2003,256,379,635,0,
4915,44300,"State College, PA Metro Area",Bus,2004,224,318,542,0,
4916,44300,"State College, PA Metro Area",Bus,2005,246,309,555,0,
4917,44300,"State College, PA Metro Area",Bus,2006,368,217,585,0,
4918,44300,"State College, PA Metro Area",Bus,2007,519,215,734,0,
4919,44300,"State College, PA Metro Area",Bus,2008,346,352,698,0,
4920,44300,"State College, PA Metro Area",Bus,2009,206,344,550,0,
4921,44300,"State College, PA Metro Area",Bus,2010,369,319,688,0,
4922,44300,"State College, PA Metro Area",Bus,2011,378,347,725,0,
4923,44300,"State College, PA Metro Area",Bus,2012,41,649,690,0,
4924,44300,"State College, PA Metro Area",Bus,2013,54,425,479,0,
4925,44300,"State College, PA Metro Area",Bus,2014,77,354,431,0,
4926,44300,"State College, PA Metro Area",Bus,2015,55,388,443,0,
4927,44300,"State College, PA Metro Area",Bus,2016,63,397,460,0,
4928,44300,"State College, PA Metro Area",Bus,2017,83,307,390,0,
4929,44300,"State College, PA Metro Area",Bus,2018,81,51,132,0,
4930,44700,"Stockton, CA Metro Area",Bus,2002,8,238,246,0,
4931,44700,"Stockton, CA Metro Area",Bus,2003,192,235,427,0,
4932,44700,"Stockton, CA Metro Area",Bus,2004,131,327,458,0,
4933,44700,"Stockton, CA Metro Area",Bus,2005,324,119,443,0,
4934,44700,"Stockton, CA Metro Area",Bus,2006,401,283,684,0,
4935,44700,"Stockton, CA Metro Area",Bus,2007,389,316,705,0,
4936,44700,"Stockton, CA Metro Area",Bus,2008,329,387,716,0,
4937,44700,"Stockton, CA Metro Area",Bus,2009,492,177,669,0,
4938,44700,"Stockton, CA Metro Area",Bus,2010,437,158,595,0,
4939,44700,"Stockton, CA Metro Area",Bus,2011,308,69,377,0,
4940,44700,"Stockton, CA Metro Area",Bus,2012,437,594,1031,0,
4941,44700,"Stockton, CA Metro Area",Bus,2013,256,66,322,0,
4942,44700,"Stockton, CA Metro Area",Bus,2014,257,168,425,0,
4943,44700,"Stockton, CA Metro Area",Bus,2015,252,272,524,0,
4944,44700,"Stockton, CA Metro Area",Bus,2016,304,132,436,0,
4945,44700,"Stockton, CA Metro Area",Bus,2017,290,249,539,0,
4946,44700,"Stockton, CA Metro Area",Bus,2018,178,208,386,0,
4947,44700,"Stockton, CA Metro Area",Rail,2002,0,0,0,0,
4948,44700,"Stockton, CA Metro Area",Rail,2003,0,0,0,0,
4949,44700,"Stockton, CA Metro Area",Rail,2004,0,0,0,0,
4950,44700,"Stockton, CA Metro Area",Rail,2005,0,0,0,0,
4951,44700,"Stockton, CA Metro Area",Rail,2006,0,0,0,0,
4952,44700,"Stockton, CA Metro Area",Rail,2007,0,0,0,0,
4953,44700,"Stockton, CA Metro Area",Rail,2008,1,0,1,0,
4954,44700,"Stockton, CA Metro Area",Rail,2009,1,0,1,0,
4955,44700,"Stockton, CA Metro Area",Rail,2010,1,0,1,0,
4956,44700,"Stockton, CA Metro Area",Rail,2011,1,7,8,0,
4957,44700,"Stockton, CA Metro Area",Rail,2012,1,0,1,0,
4958,44700,"Stockton, CA Metro Area",Rail,2013,0,0,0,0,
4959,44700,"Stockton, CA Metro Area",Rail,2014,2,0,2,0,
4960,44700,"Stockton, CA Metro Area",Rail,2015,2,1,3,0,
4961,44700,"Stockton, CA Metro Area",Rail,2016,6,0,6,0,
4962,44700,"Stockton, CA Metro Area",Rail,2017,12,0,12,0,
4963,44700,"Stockton, CA Metro Area",Rail,2018,8,0,8,0,
4964,44940,"Sumter, SC Metro Area",Bus,2002,81,155,236,0,
4965,44940,"Sumter, SC Metro Area",Bus,2003,48,118,166,0,
4966,44940,"Sumter, SC Metro Area",Bus,2004,225,101,326,0,
4967,44940,"Sumter, SC Metro Area",Bus,2005,197,90,287,0,
4968,44940,"Sumter, SC Metro Area",Bus,2006,206,83,289,0,
4969,44940,"Sumter, SC Metro Area",Bus,2007,317,145,462,0,
4970,44940,"Sumter, SC Metro Area",Bus,2008,296,144,440,0,
4971,44940,"Sumter, SC Metro Area",Bus,2009,159,118,277,0,
4972,44940,"Sumter, SC Metro Area",Bus,2010,110,142,252,0,
4973,44940,"Sumter, SC Metro Area",Bus,2011,116,150,266,0,
4974,44940,"Sumter, SC Metro Area",Bus,2012,73,309,382,0,
4975,44940,"Sumter, SC Metro Area",Bus,2013,194,326,520,0,
4976,44940,"Sumter, SC Metro Area",Bus,2014,243,479,722,0,
4977,44940,"Sumter, SC Metro Area",Bus,2015,296,422,718,0,
4978,44940,"Sumter, SC Metro Area",Bus,2016,284,275,559,0,
4979,44940,"Sumter, SC Metro Area",Bus,2017,170,228,398,0,
4980,44940,"Sumter, SC Metro Area",Bus,2018,144,256,400,0,
4981,45060,"Syracuse, NY Metro Area",Bus,2002,528,345,873,0,
4982,45060,"Syracuse, NY Metro Area",Bus,2003,588,385,973,0,
4983,45060,"Syracuse, NY Metro Area",Bus,2004,751,386,1137,0,
4984,45060,"Syracuse, NY Metro Area",Bus,2005,717,476,1193,0,
4985,45060,"Syracuse, NY Metro Area",Bus,2006,362,192,554,0,
4986,45060,"Syracuse, NY Metro Area",Bus,2007,402,212,614,0,
4987,45060,"Syracuse, NY Metro Area",Bus,2008,399,189,588,0,
4988,45060,"Syracuse, NY Metro Area",Bus,2009,285,314,599,0,
4989,45060,"Syracuse, NY Metro Area",Bus,2010,276,355,631,0,
4990,45060,"Syracuse, NY Metro Area",Bus,2011,288,379,667,0,
4991,45060,"Syracuse, NY Metro Area",Bus,2012,276,395,671,0,
4992,45060,"Syracuse, NY Metro Area",Bus,2013,285,402,687,0,
4993,45060,"Syracuse, NY Metro Area",Bus,2014,183,202,385,0,
4994,45060,"Syracuse, NY Metro Area",Bus,2015,303,1072,1375,0,
4995,45060,"Syracuse, NY Metro Area",Bus,2016,490,1320,1810,0,
4996,45060,"Syracuse, NY Metro Area",Bus,2017,564,1133,1697,0,
4997,45060,"Syracuse, NY Metro Area",Bus,2018,350,1010,1360,0,
4998,45220,"Tallahassee, FL Metro Area",Bus,2002,83,10,93,0,
4999,45220,"Tallahassee, FL Metro Area",Bus,2003,79,12,91,0,
5000,45220,"Tallahassee, FL Metro Area",Bus,2004,69,78,147,0,
5001,45220,"Tallahassee, FL Metro Area",Bus,2005,76,84,160,0,
5002,45220,"Tallahassee, FL Metro Area",Bus,2006,71,68,139,0,
5003,45220,"Tallahassee, FL Metro Area",Bus,2007,68,52,120,0,
5004,45220,"Tallahassee, FL Metro Area",Bus,2008,62,52,114,0,
5005,45220,"Tallahassee, FL Metro Area",Bus,2009,48,69,117,0,
5006,45220,"Tallahassee, FL Metro Area",Bus,2010,46,66,112,0,
5007,45220,"Tallahassee, FL Metro Area",Bus,2011,45,60,105,0,
5008,45220,"Tallahassee, FL Metro Area",Bus,2012,59,89,148,0,
5009,45220,"Tallahassee, FL Metro Area",Bus,2013,42,104,146,0,
5010,45220,"Tallahassee, FL Metro Area",Bus,2014,21,132,153,0,
5011,45220,"Tallahassee, FL Metro Area",Bus,2015,12,150,162,0,
5012,45220,"Tallahassee, FL Metro Area",Bus,2016,12,158,170,0,
5013,45220,"Tallahassee, FL Metro Area",Bus,2017,42,168,210,0,
5014,45220,"Tallahassee, FL Metro Area",Bus,2018,59,166,225,0,
5015,45300,"Tampa-St. Petersburg-Clearwater, FL Metro Area",Bus,2002,1726,417,2143,0,
5016,45300,"Tampa-St. Petersburg-Clearwater, FL Metro Area",Bus,2003,1839,2328,4167,0,
5017,45300,"Tampa-St. Petersburg-Clearwater, FL Metro Area",Bus,2004,2874,1190,4064,0,
5018,45300,"Tampa-St. Petersburg-Clearwater, FL Metro Area",Bus,2005,3784,1695,5479,0,
5019,45300,"Tampa-St. Petersburg-Clearwater, FL Metro Area",Bus,2006,1677,2101,3778,0,
5020,45300,"Tampa-St. Petersburg-Clearwater, FL Metro Area",Bus,2007,2417,1102,3519,0,
5021,45300,"Tampa-St. Petersburg-Clearwater, FL Metro Area",Bus,2008,2175,1473,3648,0,
5022,45300,"Tampa-St. Petersburg-Clearwater, FL Metro Area",Bus,2009,2361,1218,3579,0,
5023,45300,"Tampa-St. Petersburg-Clearwater, FL Metro Area",Bus,2010,2035,1624,3659,0,
5024,45300,"Tampa-St. Petersburg-Clearwater, FL Metro Area",Bus,2011,2484,1084,3568,0,
5025,45300,"Tampa-St. Petersburg-Clearwater, FL Metro Area",Bus,2012,2493,820,3313,0,
5026,45300,"Tampa-St. Petersburg-Clearwater, FL Metro Area",Bus,2013,2237,1254,3491,0,
5027,45300,"Tampa-St. Petersburg-Clearwater, FL Metro Area",Bus,2014,3000,1184,4184,0,
5028,45300,"Tampa-St. Petersburg-Clearwater, FL Metro Area",Bus,2015,2490,1796,4286,0,
5029,45300,"Tampa-St. Petersburg-Clearwater, FL Metro Area",Bus,2016,2189,1118,3307,0,
5030,45300,"Tampa-St. Petersburg-Clearwater, FL Metro Area",Bus,2017,1783,1044,2827,0,
5031,45300,"Tampa-St. Petersburg-Clearwater, FL Metro Area",Bus,2018,1744,665,2409,0,
5032,45300,"Tampa-St. Petersburg-Clearwater, FL Metro Area",Rail,2002,0,0,0,0,
5033,45300,"Tampa-St. Petersburg-Clearwater, FL Metro Area",Rail,2003,37,3,40,0,
5034,45300,"Tampa-St. Petersburg-Clearwater, FL Metro Area",Rail,2004,9,3,12,0,
5035,45300,"Tampa-St. Petersburg-Clearwater, FL Metro Area",Rail,2005,7,4,11,0,
5036,45300,"Tampa-St. Petersburg-Clearwater, FL Metro Area",Rail,2006,4,34,38,0,
5037,45300,"Tampa-St. Petersburg-Clearwater, FL Metro Area",Rail,2007,6,57,63,0,
5038,45300,"Tampa-St. Petersburg-Clearwater, FL Metro Area",Rail,2008,3,47,50,0,
5039,45300,"Tampa-St. Petersburg-Clearwater, FL Metro Area",Rail,2009,19,15,34,0,
5040,45300,"Tampa-St. Petersburg-Clearwater, FL Metro Area",Rail,2010,48,27,75,0,
5041,45300,"Tampa-St. Petersburg-Clearwater, FL Metro Area",Rail,2011,63,18,81,0,
5042,45300,"Tampa-St. Petersburg-Clearwater, FL Metro Area",Rail,2012,10,7,17,0,
5043,45300,"Tampa-St. Petersburg-Clearwater, FL Metro Area",Rail,2013,128,12,140,0,
5044,45300,"Tampa-St. Petersburg-Clearwater, FL Metro Area",Rail,2014,80,49,129,0,
5045,45300,"Tampa-St. Petersburg-Clearwater, FL Metro Area",Rail,2015,88,23,111,0,
5046,45300,"Tampa-St. Petersburg-Clearwater, FL Metro Area",Rail,2016,95,21,116,0,
5047,45300,"Tampa-St. Petersburg-Clearwater, FL Metro Area",Rail,2017,167,74,241,0,
5048,45300,"Tampa-St. Petersburg-Clearwater, FL Metro Area",Rail,2018,126,15,141,0,
5049,45460,"Terre Haute, IN Metro Area",Bus,2002,20,18,38,0,
5050,45460,"Terre Haute, IN Metro Area",Bus,2003,21,10,31,0,
5051,45460,"Terre Haute, IN Metro Area",Bus,2004,11,0,11,0,
5052,45460,"Terre Haute, IN Metro Area",Bus,2005,15,10,25,0,
5053,45460,"Terre Haute, IN Metro Area",Bus,2006,28,15,43,0,
5054,45460,"Terre Haute, IN Metro Area",Bus,2007,31,22,53,0,
5055,45460,"Terre Haute, IN Metro Area",Bus,2008,46,36,82,0,
5056,45460,"Terre Haute, IN Metro Area",Bus,2009,47,54,101,0,
5057,45460,"Terre Haute, IN Metro Area",Bus,2010,59,76,135,0,
5058,45460,"Terre Haute, IN Metro Area",Bus,2011,90,57,147,0,
5059,45460,"Terre Haute, IN Metro Area",Bus,2012,34,36,70,0,
5060,45460,"Terre Haute, IN Metro Area",Bus,2013,62,43,105,0,
5061,45460,"Terre Haute, IN Metro Area",Bus,2014,72,64,136,0,
5062,45460,"Terre Haute, IN Metro Area",Bus,2015,33,27,60,0,
5063,45460,"Terre Haute, IN Metro Area",Bus,2016,24,41,65,0,
5064,45460,"Terre Haute, IN Metro Area",Bus,2017,57,40,97,0,
5065,45460,"Terre Haute, IN Metro Area",Bus,2018,39,24,63,0,
5083,45780,"Toledo, OH Metro Area",Bus,2002,966,1256,2222,0,
5084,45780,"Toledo, OH Metro Area",Bus,2003,629,990,1619,0,
5085,45780,"Toledo, OH Metro Area",Bus,2004,1402,677,2079,0,
5086,45780,"Toledo, OH Metro Area",Bus,2005,1694,825,2519,0,
5087,45780,"Toledo, OH Metro Area",Bus,2006,932,1222,2154,0,
5088,45780,"Toledo, OH Metro Area",Bus,2007,516,1400,1916,0,
5089,45780,"Toledo, OH Metro Area",Bus,2008,512,1010,1522,0,
5090,45780,"Toledo, OH Metro Area",Bus,2009,325,1250,1575,0,
5091,45780,"Toledo, OH Metro Area",Bus,2010,159,364,523,0,
5092,45780,"Toledo, OH Metro Area",Bus,2011,211,1035,1246,0,
5093,45780,"Toledo, OH Metro Area",Bus,2012,224,793,1017,0,
5094,45780,"Toledo, OH Metro Area",Bus,2013,247,826,1073,0,
5095,45780,"Toledo, OH Metro Area",Bus,2014,299,917,1216,0,
5096,45780,"Toledo, OH Metro Area",Bus,2015,206,1141,1347,0,
5097,45780,"Toledo, OH Metro Area",Bus,2016,120,1371,1491,0,
5098,45780,"Toledo, OH Metro Area",Bus,2017,120,1371,1491,0,
5099,45780,"Toledo, OH Metro Area",Bus,2018,498,801,1299,0,
5100,45820,"Topeka, KS Metro Area",Bus,2002,22,36,58,0,
5101,45820,"Topeka, KS Metro Area",Bus,2003,42,17,59,0,
5102,45820,"Topeka, KS Metro Area",Bus,2004,27,21,48,0,
5103,45820,"Topeka, KS Metro Area",Bus,2005,28,19,47,0,
5104,45820,"Topeka, KS Metro Area",Bus,2006,10,25,35,0,
5105,45820,"Topeka, KS Metro Area",Bus,2007,27,18,45,0,
5106,45820,"Topeka, KS Metro Area",Bus,2008,2,41,43,0,
5107,45820,"Topeka, KS Metro Area",Bus,2009,20,58,78,0,
5108,45820,"Topeka, KS Metro Area",Bus,2010,68,575,643,0,
5109,45820,"Topeka, KS Metro Area",Bus,2011,119,530,649,0,
5110,45820,"Topeka, KS Metro Area",Bus,2012,69,378,447,0,
5111,45820,"Topeka, KS Metro Area",Bus,2013,75,158,233,0,
5112,45820,"Topeka, KS Metro Area",Bus,2014,50,48,98,0,
5113,45820,"Topeka, KS Metro Area",Bus,2015,29,35,64,0,
5114,45820,"Topeka, KS Metro Area",Bus,2016,25,30,55,0,
5115,45820,"Topeka, KS Metro Area",Bus,2017,15,25,40,0,
5116,45820,"Topeka, KS Metro Area",Bus,2018,24,21,45,0,
5117,46060,"Tucson, AZ Metro Area",Bus,2002,4685,1620,6305,0,
5118,46060,"Tucson, AZ Metro Area",Bus,2003,4430,730,5160,0,
5119,46060,"Tucson, AZ Metro Area",Bus,2004,3850,1076,4926,0,
5120,46060,"Tucson, AZ Metro Area",Bus,2005,1152,1193,2345,0,
5121,46060,"Tucson, AZ Metro Area",Bus,2006,1331,1370,2701,0,
5122,46060,"Tucson, AZ Metro Area",Bus,2007,1167,1842,3009,0,
5123,46060,"Tucson, AZ Metro Area",Bus,2008,1134,2115,3249,0,
5124,46060,"Tucson, AZ Metro Area",Bus,2009,1197,1916,3113,0,
5125,46060,"Tucson, AZ Metro Area",Bus,2010,1272,1946,3218,0,
5126,46060,"Tucson, AZ Metro Area",Bus,2011,1339,247,1586,0,
5127,46060,"Tucson, AZ Metro Area",Bus,2012,1123,334,1457,0,
5128,46060,"Tucson, AZ Metro Area",Bus,2013,1194,352,1546,0,
5129,46060,"Tucson, AZ Metro Area",Bus,2014,1067,319,1386,0,
5130,46060,"Tucson, AZ Metro Area",Bus,2015,752,160,912,0,
5131,46060,"Tucson, AZ Metro Area",Bus,2016,905,289,1194,0,
5132,46060,"Tucson, AZ Metro Area",Bus,2017,922,317,1239,0,
5133,46060,"Tucson, AZ Metro Area",Bus,2018,1102,393,1495,0,
5134,46060,"Tucson, AZ Metro Area",Rail,2002,0,0,0,0,
5135,46060,"Tucson, AZ Metro Area",Rail,2003,0,0,0,0,
5136,46060,"Tucson, AZ Metro Area",Rail,2004,0,0,0,0,
5137,46060,"Tucson, AZ Metro Area",Rail,2005,0,0,0,0,
5138,46060,"Tucson, AZ Metro Area",Rail,2006,0,0,0,0,
5139,46060,"Tucson, AZ Metro Area",Rail,2007,0,0,0,0,
5140,46060,"Tucson, AZ Metro Area",Rail,2008,0,0,0,0,
5141,46060,"Tucson, AZ Metro Area",Rail,2009,0,0,0,0,
5142,46060,"Tucson, AZ Metro Area",Rail,2010,0,0,0,0,
5143,46060,"Tucson, AZ Metro Area",Rail,2011,0,0,0,0,
5144,46060,"Tucson, AZ Metro Area",Rail,2012,0,0,0,0,
5145,46060,"Tucson, AZ Metro Area",Rail,2013,0,0,0,0,
5146,46060,"Tucson, AZ Metro Area",Rail,2014,0,0,0,0,
5147,46060,"Tucson, AZ Metro Area",Rail,2015,88,37,125,0,
5148,46060,"Tucson, AZ Metro Area",Rail,2016,26,15,41,0,
5149,46060,"Tucson, AZ Metro Area",Rail,2017,18,54,72,0,
5150,46060,"Tucson, AZ Metro Area",Rail,2018,15,66,81,0,
5151,46140,"Tulsa, OK Metro Area",Bus,2002,468,122,590,0,
5152,46140,"Tulsa, OK Metro Area",Bus,2003,101,250,351,0,
5153,46140,"Tulsa, OK Metro Area",Bus,2004,108,120,228,0,
5154,46140,"Tulsa, OK Metro Area",Bus,2005,99,152,251,0,
5155,46140,"Tulsa, OK Metro Area",Bus,2006,92,124,216,0,
5156,46140,"Tulsa, OK Metro Area",Bus,2007,62,121,183,0,
5157,46140,"Tulsa, OK Metro Area",Bus,2008,46,34,80,0,
5158,46140,"Tulsa, OK Metro Area",Bus,2009,121,135,256,0,
5159,46140,"Tulsa, OK Metro Area",Bus,2010,119,149,268,0,
5160,46140,"Tulsa, OK Metro Area",Bus,2011,96,125,221,0,
5161,46140,"Tulsa, OK Metro Area",Bus,2012,250,82,332,0,
5162,46140,"Tulsa, OK Metro Area",Bus,2013,189,46,235,0,
5163,46140,"Tulsa, OK Metro Area",Bus,2014,230,63,293,0,
5164,46140,"Tulsa, OK Metro Area",Bus,2015,177,112,289,0,
5165,46140,"Tulsa, OK Metro Area",Bus,2016,241,107,348,0,
5166,46140,"Tulsa, OK Metro Area",Bus,2017,243,48,291,0,
5167,46140,"Tulsa, OK Metro Area",Bus,2018,266,43,309,0,
1700,46700,"Vallejo-Fairfield, CA Metro Area",Bus,2002,0,0,0,1,
5237,46700,"Vallejo-Fairfield, CA Metro Area",Bus,2002,0,0,0,1,
1701,46700,"Vallejo-Fairfield, CA Metro Area",Bus,2003,0,0,0,1,
5239,46700,"Vallejo-Fairfield, CA Metro Area",Bus,2003,0,0,0,1,
1702,46700,"Vallejo-Fairfield, CA Metro Area",Bus,2004,0,0,0,1,
5241,46700,"Vallejo-Fairfield, CA Metro Area",Bus,2004,0,0,0,1,
1703,46700,"Vallejo-Fairfield, CA Metro Area",Bus,2005,0,0,0,1,
5243,46700,"Vallejo-Fairfield, CA Metro Area",Bus,2005,0,0,0,1,
1704,46700,"Vallejo-Fairfield, CA Metro Area",Bus,2006,0,0,0,1,
5245,46700,"Vallejo-Fairfield, CA Metro Area",Bus,2006,0,0,0,1,
1705,46700,"Vallejo-Fairfield, CA Metro Area",Bus,2007,0,0,0,1,
5247,46700,"Vallejo-Fairfield, CA Metro Area",Bus,2007,0,0,0,1,
1706,46700,"Vallejo-Fairfield, CA Metro Area",Bus,2008,0,0,0,1,
5249,46700,"Vallejo-Fairfield, CA Metro Area",Bus,2008,0,0,0,1,
1707,46700,"Vallejo-Fairfield, CA Metro Area",Bus,2009,238,188,426,0,
5251,46700,"Vallejo-Fairfield, CA Metro Area",Bus,2009,0,0,0,0,
1708,46700,"Vallejo-Fairfield, CA Metro Area",Bus,2010,165,56,221,0,
5253,46700,"Vallejo-Fairfield, CA Metro Area",Bus,2010,0,0,0,0,
1709,46700,"Vallejo-Fairfield, CA Metro Area",Bus,2011,179,49,228,0,
5255,46700,"Vallejo-Fairfield, CA Metro Area",Bus,2011,0,0,0,0,
1710,46700,"Vallejo-Fairfield, CA Metro Area",Bus,2012,180,112,292,0,
5257,46700,"Vallejo-Fairfield, CA Metro Area",Bus,2012,14,24,38,0,
1711,46700,"Vallejo-Fairfield, CA Metro Area",Bus,2013,101,59,160,0,
5259,46700,"Vallejo-Fairfield, CA Metro Area",Bus,2013,83,147,230,0,
1712,46700,"Vallejo-Fairfield, CA Metro Area",Bus,2014,90,73,163,0,
5261,46700,"Vallejo-Fairfield, CA Metro Area",Bus,2014,209,159,368,0,
1713,46700,"Vallejo-Fairfield, CA Metro Area",Bus,2015,134,55,189,0,
5263,46700,"Vallejo-Fairfield, CA Metro Area",Bus,2015,167,85,252,0,
1714,46700,"Vallejo-Fairfield, CA Metro Area",Bus,2016,128,53,181,0,
5265,46700,"Vallejo-Fairfield, CA Metro Area",Bus,2016,215,53,268,0,
1715,46700,"Vallejo-Fairfield, CA Metro Area",Bus,2017,292,39,331,0,
5267,46700,"Vallejo-Fairfield, CA Metro Area",Bus,2017,262,55,317,0,
1716,46700,"Vallejo-Fairfield, CA Metro Area",Bus,2018,325,35,360,0,
5269,46700,"Vallejo-Fairfield, CA Metro Area",Bus,2018,190,40,230,0,
5287,47260,"Virginia Beach-Norfolk-Newport News, VA-NC Metro Area",Bus,2002,1576,3448,5024,0,
5474,47260,"Virginia Beach-Norfolk-Newport News, VA-NC Metro Area",Bus,2002,25,13,38,0,
5288,47260,"Virginia Beach-Norfolk-Newport News, VA-NC Metro Area",Bus,2003,2362,3358,5720,0,
5475,47260,"Virginia Beach-Norfolk-Newport News, VA-NC Metro Area",Bus,2003,0,13,13,0,
5289,47260,"Virginia Beach-Norfolk-Newport News, VA-NC Metro Area",Bus,2004,3158,4470,7628,0,
5476,47260,"Virginia Beach-Norfolk-Newport News, VA-NC Metro Area",Bus,2004,0,4,4,0,
5290,47260,"Virginia Beach-Norfolk-Newport News, VA-NC Metro Area",Bus,2005,2738,3940,6678,0,
5477,47260,"Virginia Beach-Norfolk-Newport News, VA-NC Metro Area",Bus,2005,4,2,6,0,
5291,47260,"Virginia Beach-Norfolk-Newport News, VA-NC Metro Area",Bus,2006,2915,3489,6404,0,
5478,47260,"Virginia Beach-Norfolk-Newport News, VA-NC Metro Area",Bus,2006,9,56,65,0,
5292,47260,"Virginia Beach-Norfolk-Newport News, VA-NC Metro Area",Bus,2007,3596,2159,5755,0,
5479,47260,"Virginia Beach-Norfolk-Newport News, VA-NC Metro Area",Bus,2007,0,6,6,0,
5293,47260,"Virginia Beach-Norfolk-Newport News, VA-NC Metro Area",Bus,2008,3589,1088,4677,0,
5480,47260,"Virginia Beach-Norfolk-Newport News, VA-NC Metro Area",Bus,2008,6,51,57,0,
5294,47260,"Virginia Beach-Norfolk-Newport News, VA-NC Metro Area",Bus,2009,2900,759,3659,0,
5481,47260,"Virginia Beach-Norfolk-Newport News, VA-NC Metro Area",Bus,2009,7,24,31,0,
5295,47260,"Virginia Beach-Norfolk-Newport News, VA-NC Metro Area",Bus,2010,3733,699,4432,0,
5482,47260,"Virginia Beach-Norfolk-Newport News, VA-NC Metro Area",Bus,2010,97,612,709,0,
5296,47260,"Virginia Beach-Norfolk-Newport News, VA-NC Metro Area",Bus,2011,3778,580,4358,0,
5483,47260,"Virginia Beach-Norfolk-Newport News, VA-NC Metro Area",Bus,2011,37,62,99,0,
5297,47260,"Virginia Beach-Norfolk-Newport News, VA-NC Metro Area",Bus,2012,2551,719,3270,0,
5484,47260,"Virginia Beach-Norfolk-Newport News, VA-NC Metro Area",Bus,2012,24,106,130,0,
5298,47260,"Virginia Beach-Norfolk-Newport News, VA-NC Metro Area",Bus,2013,1624,1052,2676,0,
5485,47260,"Virginia Beach-Norfolk-Newport News, VA-NC Metro Area",Bus,2013,48,40,88,0,
5299,47260,"Virginia Beach-Norfolk-Newport News, VA-NC Metro Area",Bus,2014,2422,193,2615,0,
5486,47260,"Virginia Beach-Norfolk-Newport News, VA-NC Metro Area",Bus,2014,182,68,250,0,
5300,47260,"Virginia Beach-Norfolk-Newport News, VA-NC Metro Area",Bus,2015,2724,1774,4498,0,
5487,47260,"Virginia Beach-Norfolk-Newport News, VA-NC Metro Area",Bus,2015,210,9,219,0,
5301,47260,"Virginia Beach-Norfolk-Newport News, VA-NC Metro Area",Bus,2016,1593,1935,3528,0,
5488,47260,"Virginia Beach-Norfolk-Newport News, VA-NC Metro Area",Bus,2016,105,4,109,0,
5302,47260,"Virginia Beach-Norfolk-Newport News, VA-NC Metro Area",Bus,2017,1138,1648,2786,0,
5489,47260,"Virginia Beach-Norfolk-Newport News, VA-NC Metro Area",Bus,2017,62,11,73,0,
5303,47260,"Virginia Beach-Norfolk-Newport News, VA-NC Metro Area",Bus,2018,1231,1809,3040,0,
5490,47260,"Virginia Beach-Norfolk-Newport News, VA-NC Metro Area",Bus,2018,40,3,43,0,
5304,47260,"Virginia Beach-Norfolk-Newport News, VA-NC Metro Area",Rail,2002,0,0,0,0,
5305,47260,"Virginia Beach-Norfolk-Newport News, VA-NC Metro Area",Rail,2003,0,0,0,0,
5306,47260,"Virginia Beach-Norfolk-Newport News, VA-NC Metro Area",Rail,2004,0,0,0,0,
5307,47260,"Virginia Beach-Norfolk-Newport News, VA-NC Metro Area",Rail,2005,0,0,0,0,
5308,47260,"Virginia Beach-Norfolk-Newport News, VA-NC Metro Area",Rail,2006,0,0,0,0,
5309,47260,"Virginia Beach-Norfolk-Newport News, VA-NC Metro Area",Rail,2007,0,0,0,0,
5310,47260,"Virginia Beach-Norfolk-Newport News, VA-NC Metro Area",Rail,2008,0,0,0,0,
5311,47260,"Virginia Beach-Norfolk-Newport News, VA-NC Metro Area",Rail,2009,0,0,0,0,
5312,47260,"Virginia Beach-Norfolk-Newport News, VA-NC Metro Area",Rail,2010,0,0,0,0,
5313,47260,"Virginia Beach-Norfolk-Newport News, VA-NC Metro Area",Rail,2011,0,0,0,0,
5314,47260,"Virginia Beach-Norfolk-Newport News, VA-NC Metro Area",Rail,2012,23,25,48,0,
5315,47260,"Virginia Beach-Norfolk-Newport News, VA-NC Metro Area",Rail,2013,0,88,88,0,
5316,47260,"Virginia Beach-Norfolk-Newport News, VA-NC Metro Area",Rail,2014,68,0,68,0,
5317,47260,"Virginia Beach-Norfolk-Newport News, VA-NC Metro Area",Rail,2015,52,3,55,0,
5318,47260,"Virginia Beach-Norfolk-Newport News, VA-NC Metro Area",Rail,2016,50,9,59,0,
5319,47260,"Virginia Beach-Norfolk-Newport News, VA-NC Metro Area",Rail,2017,34,0,34,0,
5320,47260,"Virginia Beach-Norfolk-Newport News, VA-NC Metro Area",Rail,2018,45,0,45,0,
5321,47300,"Visalia-Porterville, CA Metro Area",Bus,2002,0,0,0,1,
5322,47300,"Visalia-Porterville, CA Metro Area",Bus,2003,0,0,0,1,
5323,47300,"Visalia-Porterville, CA Metro Area",Bus,2004,0,0,0,1,
5324,47300,"Visalia-Porterville, CA Metro Area",Bus,2005,0,0,0,1,
5325,47300,"Visalia-Porterville, CA Metro Area",Bus,2006,0,0,0,1,
5326,47300,"Visalia-Porterville, CA Metro Area",Bus,2007,0,0,0,1,
5327,47300,"Visalia-Porterville, CA Metro Area",Bus,2008,60,29,89,0,
5328,47300,"Visalia-Porterville, CA Metro Area",Bus,2009,34,1,35,0,
5329,47300,"Visalia-Porterville, CA Metro Area",Bus,2010,47,24,71,0,
5330,47300,"Visalia-Porterville, CA Metro Area",Bus,2011,45,4,49,0,
5331,47300,"Visalia-Porterville, CA Metro Area",Bus,2012,129,65,194,0,
5332,47300,"Visalia-Porterville, CA Metro Area",Bus,2013,55,212,267,0,
5333,47300,"Visalia-Porterville, CA Metro Area",Bus,2014,83,278,361,0,
5334,47300,"Visalia-Porterville, CA Metro Area",Bus,2015,82,241,323,0,
5335,47300,"Visalia-Porterville, CA Metro Area",Bus,2016,69,209,278,0,
5336,47300,"Visalia-Porterville, CA Metro Area",Bus,2017,44,12,56,0,
5337,47300,"Visalia-Porterville, CA Metro Area",Bus,2018,29,14,43,0,
5338,47380,"Waco, TX Metro Area",Bus,2002,0,0,0,0,
5339,47380,"Waco, TX Metro Area",Bus,2003,2,3,5,0,
5340,47380,"Waco, TX Metro Area",Bus,2004,1,2,3,0,
5341,47380,"Waco, TX Metro Area",Bus,2005,8,0,8,0,
5342,47380,"Waco, TX Metro Area",Bus,2006,17,10,27,0,
5343,47380,"Waco, TX Metro Area",Bus,2007,33,6,39,0,
5344,47380,"Waco, TX Metro Area",Bus,2008,31,22,53,0,
5345,47380,"Waco, TX Metro Area",Bus,2009,59,22,81,0,
5346,47380,"Waco, TX Metro Area",Bus,2010,45,42,87,0,
5347,47380,"Waco, TX Metro Area",Bus,2011,34,36,70,0,
5348,47380,"Waco, TX Metro Area",Bus,2012,31,53,84,0,
5349,47380,"Waco, TX Metro Area",Bus,2013,132,132,264,0,
5350,47380,"Waco, TX Metro Area",Bus,2014,67,6,73,0,
5351,47380,"Waco, TX Metro Area",Bus,2015,73,21,94,0,
5352,47380,"Waco, TX Metro Area",Bus,2016,60,3,63,0,
5353,47380,"Waco, TX Metro Area",Bus,2017,30,1,31,0,
5354,47380,"Waco, TX Metro Area",Bus,2018,64,198,262,0,
1853,47900,"Washington-Arlington-Alexandria, DC-VA-MD-WV Metro Area",Bus,2002,7,0,7,0,
5355,47900,"Washington-Arlington-Alexandria, DC-VA-MD-WV Metro Area",Bus,2002,0,0,0,0,
5372,47900,"Washington-Arlington-Alexandria, DC-VA-MD-WV Metro Area",Bus,2002,5605,4009,9614,0,
1854,47900,"Washington-Arlington-Alexandria, DC-VA-MD-WV Metro Area",Bus,2003,13,8,21,0,
5356,47900,"Washington-Arlington-Alexandria, DC-VA-MD-WV Metro Area",Bus,2003,0,0,0,0,
5373,47900,"Washington-Arlington-Alexandria, DC-VA-MD-WV Metro Area",Bus,2003,6267,3825,10092,0,
1855,47900,"Washington-Arlington-Alexandria, DC-VA-MD-WV Metro Area",Bus,2004,17,1,18,0,
5357,47900,"Washington-Arlington-Alexandria, DC-VA-MD-WV Metro Area",Bus,2004,0,0,0,0,
5374,47900,"Washington-Arlington-Alexandria, DC-VA-MD-WV Metro Area",Bus,2004,7389,6634,14023,0,
1856,47900,"Washington-Arlington-Alexandria, DC-VA-MD-WV Metro Area",Bus,2005,1,3,4,0,
5358,47900,"Washington-Arlington-Alexandria, DC-VA-MD-WV Metro Area",Bus,2005,0,0,0,0,
5375,47900,"Washington-Arlington-Alexandria, DC-VA-MD-WV Metro Area",Bus,2005,7019,2447,9466,0,
1857,47900,"Washington-Arlington-Alexandria, DC-VA-MD-WV Metro Area",Bus,2006,5,5,10,0,
5359,47900,"Washington-Arlington-Alexandria, DC-VA-MD-WV Metro Area",Bus,2006,0,0,0,0,
5376,47900,"Washington-Arlington-Alexandria, DC-VA-MD-WV Metro Area",Bus,2006,7300,2780,10080,0,
1858,47900,"Washington-Arlington-Alexandria, DC-VA-MD-WV Metro Area",Bus,2007,10,9,19,0,
5360,47900,"Washington-Arlington-Alexandria, DC-VA-MD-WV Metro Area",Bus,2007,0,0,0,0,
5377,47900,"Washington-Arlington-Alexandria, DC-VA-MD-WV Metro Area",Bus,2007,6380,3139,9519,0,
1859,47900,"Washington-Arlington-Alexandria, DC-VA-MD-WV Metro Area",Bus,2008,22,46,68,0,
5361,47900,"Washington-Arlington-Alexandria, DC-VA-MD-WV Metro Area",Bus,2008,16,23,39,0,
5378,47900,"Washington-Arlington-Alexandria, DC-VA-MD-WV Metro Area",Bus,2008,6389,4025,10414,0,
1860,47900,"Washington-Arlington-Alexandria, DC-VA-MD-WV Metro Area",Bus,2009,16,84,100,0,
5362,47900,"Washington-Arlington-Alexandria, DC-VA-MD-WV Metro Area",Bus,2009,60,1,61,0,
5379,47900,"Washington-Arlington-Alexandria, DC-VA-MD-WV Metro Area",Bus,2009,8058,5232,13290,0,
1861,47900,"Washington-Arlington-Alexandria, DC-VA-MD-WV Metro Area",Bus,2010,83,32,115,0,
5363,47900,"Washington-Arlington-Alexandria, DC-VA-MD-WV Metro Area",Bus,2010,43,5,48,0,
5380,47900,"Washington-Arlington-Alexandria, DC-VA-MD-WV Metro Area",Bus,2010,7101,5483,12584,0,
1862,47900,"Washington-Arlington-Alexandria, DC-VA-MD-WV Metro Area",Bus,2011,65,28,93,0,
5364,47900,"Washington-Arlington-Alexandria, DC-VA-MD-WV Metro Area",Bus,2011,50,9,59,0,
5381,47900,"Washington-Arlington-Alexandria, DC-VA-MD-WV Metro Area",Bus,2011,6209,5113,11322,0,
1863,47900,"Washington-Arlington-Alexandria, DC-VA-MD-WV Metro Area",Bus,2012,17,95,112,0,
5365,47900,"Washington-Arlington-Alexandria, DC-VA-MD-WV Metro Area",Bus,2012,58,6,64,0,
5382,47900,"Washington-Arlington-Alexandria, DC-VA-MD-WV Metro Area",Bus,2012,6561,5493,12054,0,
1864,47900,"Washington-Arlington-Alexandria, DC-VA-MD-WV Metro Area",Bus,2013,26,56,82,0,
5366,47900,"Washington-Arlington-Alexandria, DC-VA-MD-WV Metro Area",Bus,2013,63,10,73,0,
5383,47900,"Washington-Arlington-Alexandria, DC-VA-MD-WV Metro Area",Bus,2013,5755,6175,11930,0,
1865,47900,"Washington-Arlington-Alexandria, DC-VA-MD-WV Metro Area",Bus,2014,40,24,64,0,
5367,47900,"Washington-Arlington-Alexandria, DC-VA-MD-WV Metro Area",Bus,2014,7,12,19,0,
5384,47900,"Washington-Arlington-Alexandria, DC-VA-MD-WV Metro Area",Bus,2014,6223,6037,12260,0,
1866,47900,"Washington-Arlington-Alexandria, DC-VA-MD-WV Metro Area",Bus,2015,34,62,96,0,
5368,47900,"Washington-Arlington-Alexandria, DC-VA-MD-WV Metro Area",Bus,2015,83,6,89,0,
5385,47900,"Washington-Arlington-Alexandria, DC-VA-MD-WV Metro Area",Bus,2015,6744,4216,10960,0,
1867,47900,"Washington-Arlington-Alexandria, DC-VA-MD-WV Metro Area",Bus,2016,21,43,64,0,
5369,47900,"Washington-Arlington-Alexandria, DC-VA-MD-WV Metro Area",Bus,2016,96,5,101,0,
5386,47900,"Washington-Arlington-Alexandria, DC-VA-MD-WV Metro Area",Bus,2016,7039,6631,13670,0,
1868,47900,"Washington-Arlington-Alexandria, DC-VA-MD-WV Metro Area",Bus,2017,50,35,85,0,
5370,47900,"Washington-Arlington-Alexandria, DC-VA-MD-WV Metro Area",Bus,2017,105,2,107,0,
5387,47900,"Washington-Arlington-Alexandria, DC-VA-MD-WV Metro Area",Bus,2017,6938,5455,12393,0,
1869,47900,"Washington-Arlington-Alexandria, DC-VA-MD-WV Metro Area",Bus,2018,36,62,98,0,
5371,47900,"Washington-Arlington-Alexandria, DC-VA-MD-WV Metro Area",Bus,2018,78,109,187,0,
5388,47900,"Washington-Arlington-Alexandria, DC-VA-MD-WV Metro Area",Bus,2018,8689,4573,13262,0,
5389,47900,"Washington-Arlington-Alexandria, DC-VA-MD-WV Metro Area",Rail,2002,5500,3050,8550,0,
5390,47900,"Washington-Arlington-Alexandria, DC-VA-MD-WV Metro Area",Rail,2003,721,499,1220,0,
5391,47900,"Washington-Arlington-Alexandria, DC-VA-MD-WV Metro Area",Rail,2004,536,339,875,0,
5392,47900,"Washington-Arlington-Alexandria, DC-VA-MD-WV Metro Area",Rail,2005,661,377,1038,0,
5393,47900,"Washington-Arlington-Alexandria, DC-VA-MD-WV Metro Area",Rail,2006,726,542,1268,0,
5394,47900,"Washington-Arlington-Alexandria, DC-VA-MD-WV Metro Area",Rail,2007,706,155,861,0,
5395,47900,"Washington-Arlington-Alexandria, DC-VA-MD-WV Metro Area",Rail,2008,1094,362,1456,0,
5396,47900,"Washington-Arlington-Alexandria, DC-VA-MD-WV Metro Area",Rail,2009,1342,161,1503,0,
5397,47900,"Washington-Arlington-Alexandria, DC-VA-MD-WV Metro Area",Rail,2010,1552,117,1669,0,
5398,47900,"Washington-Arlington-Alexandria, DC-VA-MD-WV Metro Area",Rail,2011,1533,137,1670,0,
5399,47900,"Washington-Arlington-Alexandria, DC-VA-MD-WV Metro Area",Rail,2012,1485,111,1596,0,
5400,47900,"Washington-Arlington-Alexandria, DC-VA-MD-WV Metro Area",Rail,2013,1223,139,1362,0,
5401,47900,"Washington-Arlington-Alexandria, DC-VA-MD-WV Metro Area",Rail,2014,1408,102,1510,0,
5402,47900,"Washington-Arlington-Alexandria, DC-VA-MD-WV Metro Area",Rail,2015,1645,151,1796,0,
5403,47900,"Washington-Arlington-Alexandria, DC-VA-MD-WV Metro Area",Rail,2016,1519,78,1597,0,
5404,47900,"Washington-Arlington-Alexandria, DC-VA-MD-WV Metro Area",Rail,2017,974,78,1052,0,
5405,47900,"Washington-Arlington-Alexandria, DC-VA-MD-WV Metro Area",Rail,2018,664,36,700,0,
5423,48300,"Wenatchee-East Wenatchee, WA Metro Area",Bus,2002,0,0,0,1,
5424,48300,"Wenatchee-East Wenatchee, WA Metro Area",Bus,2003,0,0,0,1,
5425,48300,"Wenatchee-East Wenatchee, WA Metro Area",Bus,2004,19,6,25,1,
5426,48300,"Wenatchee-East Wenatchee, WA Metro Area",Bus,2005,10,44,54,0,
5427,48300,"Wenatchee-East Wenatchee, WA Metro Area",Bus,2006,1,135,136,0,
5428,48300,"Wenatchee-East Wenatchee, WA Metro Area",Bus,2007,58,75,133,0,
5429,48300,"Wenatchee-East Wenatchee, WA Metro Area",Bus,2008,74,102,176,0,
5430,48300,"Wenatchee-East Wenatchee, WA Metro Area",Bus,2009,58,123,181,0,
5431,48300,"Wenatchee-East Wenatchee, WA Metro Area",Bus,2010,80,156,236,0,
5432,48300,"Wenatchee-East Wenatchee, WA Metro Area",Bus,2011,86,154,240,0,
5433,48300,"Wenatchee-East Wenatchee, WA Metro Area",Bus,2012,119,134,253,0,
5434,48300,"Wenatchee-East Wenatchee, WA Metro Area",Bus,2013,89,90,179,0,
5435,48300,"Wenatchee-East Wenatchee, WA Metro Area",Bus,2014,150,131,281,0,
5436,48300,"Wenatchee-East Wenatchee, WA Metro Area",Bus,2015,190,256,446,0,
5437,48300,"Wenatchee-East Wenatchee, WA Metro Area",Bus,2016,281,140,421,0,
5438,48300,"Wenatchee-East Wenatchee, WA Metro Area",Bus,2017,207,120,327,0,
5439,48300,"Wenatchee-East Wenatchee, WA Metro Area",Bus,2018,152,117,269,0,
5440,48540,"Wheeling, WV-OH Metro Area",Bus,2002,2,54,56,0,
5441,48540,"Wheeling, WV-OH Metro Area",Bus,2003,3,72,75,0,
5442,48540,"Wheeling, WV-OH Metro Area",Bus,2004,5,52,57,0,
5443,48540,"Wheeling, WV-OH Metro Area",Bus,2005,9,76,85,0,
5444,48540,"Wheeling, WV-OH Metro Area",Bus,2006,8,54,62,0,
5445,48540,"Wheeling, WV-OH Metro Area",Bus,2007,4,75,79,0,
5446,48540,"Wheeling, WV-OH Metro Area",Bus,2008,6,86,92,0,
5447,48540,"Wheeling, WV-OH Metro Area",Bus,2009,5,64,69,0,
5448,48540,"Wheeling, WV-OH Metro Area",Bus,2010,4,46,50,0,
5449,48540,"Wheeling, WV-OH Metro Area",Bus,2011,18,67,85,0,
5450,48540,"Wheeling, WV-OH Metro Area",Bus,2012,15,147,162,0,
5451,48540,"Wheeling, WV-OH Metro Area",Bus,2013,16,147,163,0,
5452,48540,"Wheeling, WV-OH Metro Area",Bus,2014,1,179,180,0,
5453,48540,"Wheeling, WV-OH Metro Area",Bus,2015,13,195,208,0,
5454,48540,"Wheeling, WV-OH Metro Area",Bus,2016,8,160,168,0,
5455,48540,"Wheeling, WV-OH Metro Area",Bus,2017,1,120,121,0,
5456,48540,"Wheeling, WV-OH Metro Area",Bus,2018,1,115,116,0,
5457,48620,"Wichita, KS Metro Area",Bus,2002,169,443,612,0,
5458,48620,"Wichita, KS Metro Area",Bus,2003,302,34,336,0,
5459,48620,"Wichita, KS Metro Area",Bus,2004,12,8,20,1,
5460,48620,"Wichita, KS Metro Area",Bus,2005,14,52,66,1,
5461,48620,"Wichita, KS Metro Area",Bus,2006,49,448,497,0,
5462,48620,"Wichita, KS Metro Area",Bus,2007,46,486,532,0,
5463,48620,"Wichita, KS Metro Area",Bus,2008,50,505,555,0,
5464,48620,"Wichita, KS Metro Area",Bus,2009,66,511,577,0,
5465,48620,"Wichita, KS Metro Area",Bus,2010,75,560,635,0,
5466,48620,"Wichita, KS Metro Area",Bus,2011,150,492,642,0,
5467,48620,"Wichita, KS Metro Area",Bus,2012,971,191,1162,0,
5468,48620,"Wichita, KS Metro Area",Bus,2013,623,604,1227,0,
5469,48620,"Wichita, KS Metro Area",Bus,2014,519,445,964,0,
5470,48620,"Wichita, KS Metro Area",Bus,2015,273,28,301,0,
5471,48620,"Wichita, KS Metro Area",Bus,2016,222,285,507,0,
5472,48620,"Wichita, KS Metro Area",Bus,2017,186,237,423,0,
5473,48620,"Wichita, KS Metro Area",Bus,2018,139,218,357,0,
5491,48700,"Williamsport, PA Metro Area",Bus,2002,119,107,226,0,
5492,48700,"Williamsport, PA Metro Area",Bus,2003,115,158,273,0,
5493,48700,"Williamsport, PA Metro Area",Bus,2004,190,157,347,0,
5494,48700,"Williamsport, PA Metro Area",Bus,2005,144,246,390,0,
5495,48700,"Williamsport, PA Metro Area",Bus,2006,115,239,354,0,
5496,48700,"Williamsport, PA Metro Area",Bus,2007,175,301,476,0,
5497,48700,"Williamsport, PA Metro Area",Bus,2008,147,339,486,0,
5498,48700,"Williamsport, PA Metro Area",Bus,2009,137,296,433,0,
5499,48700,"Williamsport, PA Metro Area",Bus,2010,155,296,451,0,
5500,48700,"Williamsport, PA Metro Area",Bus,2011,171,459,630,0,
5501,48700,"Williamsport, PA Metro Area",Bus,2012,159,518,677,0,
5502,48700,"Williamsport, PA Metro Area",Bus,2013,93,379,472,0,
5503,48700,"Williamsport, PA Metro Area",Bus,2014,106,393,499,0,
5504,48700,"Williamsport, PA Metro Area",Bus,2015,103,404,507,0,
5505,48700,"Williamsport, PA Metro Area",Bus,2016,119,392,511,0,
5506,48700,"Williamsport, PA Metro Area",Bus,2017,142,111,253,0,
5507,48700,"Williamsport, PA Metro Area",Bus,2018,100,123,223,0,
5508,48900,"Wilmington, NC Metro Area",Bus,2002,186,35,221,0,
5509,48900,"Wilmington, NC Metro Area",Bus,2003,167,13,180,0,
5510,48900,"Wilmington, NC Metro Area",Bus,2004,61,48,109,0,
5511,48900,"Wilmington, NC Metro Area",Bus,2005,44,91,135,0,
5512,48900,"Wilmington, NC Metro Area",Bus,2006,32,51,83,0,
5513,48900,"Wilmington, NC Metro Area",Bus,2007,38,48,86,0,
5514,48900,"Wilmington, NC Metro Area",Bus,2008,44,231,275,0,
5515,48900,"Wilmington, NC Metro Area",Bus,2009,61,371,432,0,
5516,48900,"Wilmington, NC Metro Area",Bus,2010,52,362,414,0,
5517,48900,"Wilmington, NC Metro Area",Bus,2011,42,372,414,0,
5518,48900,"Wilmington, NC Metro Area",Bus,2012,41,302,343,0,
5519,48900,"Wilmington, NC Metro Area",Bus,2013,33,278,311,0,
5520,48900,"Wilmington, NC Metro Area",Bus,2014,12,21,33,1,
5521,48900,"Wilmington, NC Metro Area",Bus,2015,297,191,488,0,
5522,48900,"Wilmington, NC Metro Area",Bus,2016,421,269,690,0,
5523,48900,"Wilmington, NC Metro Area",Bus,2017,219,114,333,0,
5524,48900,"Wilmington, NC Metro Area",Bus,2018,92,136,228,0,
5525,49180,"Winston-Salem, NC Metro Area",Bus,2002,49,194,243,0,
5526,49180,"Winston-Salem, NC Metro Area",Bus,2003,77,160,237,0,
5527,49180,"Winston-Salem, NC Metro Area",Bus,2004,109,86,195,0,
5528,49180,"Winston-Salem, NC Metro Area",Bus,2005,150,72,222,0,
5529,49180,"Winston-Salem, NC Metro Area",Bus,2006,79,32,111,0,
5530,49180,"Winston-Salem, NC Metro Area",Bus,2007,112,106,218,0,
5531,49180,"Winston-Salem, NC Metro Area",Bus,2008,101,82,183,0,
5532,49180,"Winston-Salem, NC Metro Area",Bus,2009,117,80,197,0,
5533,49180,"Winston-Salem, NC Metro Area",Bus,2010,207,154,361,0,
5534,49180,"Winston-Salem, NC Metro Area",Bus,2011,212,159,371,0,
5535,49180,"Winston-Salem, NC Metro Area",Bus,2012,148,256,404,0,
5536,49180,"Winston-Salem, NC Metro Area",Bus,2013,137,416,553,0,
5537,49180,"Winston-Salem, NC Metro Area",Bus,2014,183,488,671,0,
5538,49180,"Winston-Salem, NC Metro Area",Bus,2015,41,348,389,0,
5539,49180,"Winston-Salem, NC Metro Area",Bus,2016,15,282,297,0,
5540,49180,"Winston-Salem, NC Metro Area",Bus,2017,100,90,190,0,
5541,49180,"Winston-Salem, NC Metro Area",Bus,2018,177,163,340,0,
2788,49340,"Worcester, MA Metro Area",Bus,2002,0,0,0,0,
5542,49340,"Worcester, MA Metro Area",Bus,2002,677,247,924,0,
2789,49340,"Worcester, MA Metro Area",Bus,2003,0,0,0,0,
5543,49340,"Worcester, MA Metro Area",Bus,2003,186,276,462,0,
2790,49340,"Worcester, MA Metro Area",Bus,2004,0,0,0,0,
5544,49340,"Worcester, MA Metro Area",Bus,2004,294,644,938,0,
2791,49340,"Worcester, MA Metro Area",Bus,2005,0,0,0,0,
5545,49340,"Worcester, MA Metro Area",Bus,2005,288,387,675,0,
2792,49340,"Worcester, MA Metro Area",Bus,2006,0,0,0,0,
5546,49340,"Worcester, MA Metro Area",Bus,2006,613,267,880,0,
2793,49340,"Worcester, MA Metro Area",Bus,2007,0,0,0,0,
5547,49340,"Worcester, MA Metro Area",Bus,2007,641,560,1201,0,
2794,49340,"Worcester, MA Metro Area",Bus,2008,0,0,0,0,
5548,49340,"Worcester, MA Metro Area",Bus,2008,787,613,1400,0,
2795,49340,"Worcester, MA Metro Area",Bus,2009,67,25,92,0,
5549,49340,"Worcester, MA Metro Area",Bus,2009,791,367,1158,0,
2796,49340,"Worcester, MA Metro Area",Bus,2010,90,42,132,0,
5550,49340,"Worcester, MA Metro Area",Bus,2010,724,351,1075,0,
2797,49340,"Worcester, MA Metro Area",Bus,2011,109,80,189,0,
5551,49340,"Worcester, MA Metro Area",Bus,2011,143,390,533,0,
2798,49340,"Worcester, MA Metro Area",Bus,2012,194,115,309,0,
5552,49340,"Worcester, MA Metro Area",Bus,2012,143,664,807,0,
2799,49340,"Worcester, MA Metro Area",Bus,2013,163,26,189,0,
5553,49340,"Worcester, MA Metro Area",Bus,2013,111,573,684,0,
2800,49340,"Worcester, MA Metro Area",Bus,2014,21,58,79,0,
5554,49340,"Worcester, MA Metro Area",Bus,2014,165,788,953,0,
2801,49340,"Worcester, MA Metro Area",Bus,2015,37,59,96,0,
5555,49340,"Worcester, MA Metro Area",Bus,2015,170,632,802,0,
2802,49340,"Worcester, MA Metro Area",Bus,2016,33,55,88,0,
5556,49340,"Worcester, MA Metro Area",Bus,2016,146,771,917,0,
2803,49340,"Worcester, MA Metro Area",Bus,2017,28,52,80,0,
5557,49340,"Worcester, MA Metro Area",Bus,2017,187,833,1020,0,
2804,49340,"Worcester, MA Metro Area",Bus,2018,35,49,84,0,
5558,49340,"Worcester, MA Metro Area",Bus,2018,243,855,1098,0,
5559,49420,"Yakima, WA Metro Area",Bus,2002,21,9,30,0,
5560,49420,"Yakima, WA Metro Area",Bus,2003,27,10,37,0,
5561,49420,"Yakima, WA Metro Area",Bus,2004,27,9,36,0,
5562,49420,"Yakima, WA Metro Area",Bus,2005,15,9,24,0,
5563,49420,"Yakima, WA Metro Area",Bus,2006,14,11,25,0,
5564,49420,"Yakima, WA Metro Area",Bus,2007,3,3,6,0,
5565,49420,"Yakima, WA Metro Area",Bus,2008,18,3,21,0,
5566,49420,"Yakima, WA Metro Area",Bus,2009,4,3,7,0,
5567,49420,"Yakima, WA Metro Area",Bus,2010,18,3,21,0,
5568,49420,"Yakima, WA Metro Area",Bus,2011,3,4,7,0,
5569,49420,"Yakima, WA Metro Area",Bus,2012,87,51,138,0,
5570,49420,"Yakima, WA Metro Area",Bus,2013,39,120,159,0,
5571,49420,"Yakima, WA Metro Area",Bus,2014,33,170,203,0,
5572,49420,"Yakima, WA Metro Area",Bus,2015,51,68,119,0,
5573,49420,"Yakima, WA Metro Area",Bus,2016,41,62,103,0,
5574,49420,"Yakima, WA Metro Area",Bus,2017,49,54,103,0,
5575,49420,"Yakima, WA Metro Area",Bus,2018,55,89,144,0,
5576,49620,"York-Hanover, PA Metro Area",Bus,2002,69,78,147,0,
5577,49620,"York-Hanover, PA Metro Area",Bus,2003,48,51,99,0,
5578,49620,"York-Hanover, PA Metro Area",Bus,2004,19,22,41,0,
5579,49620,"York-Hanover, PA Metro Area",Bus,2005,17,25,42,0,
5580,49620,"York-Hanover, PA Metro Area",Bus,2006,12,19,31,0,
5581,49620,"York-Hanover, PA Metro Area",Bus,2007,26,15,41,0,
5582,49620,"York-Hanover, PA Metro Area",Bus,2008,52,13,65,0,
5583,49620,"York-Hanover, PA Metro Area",Bus,2009,54,14,68,0,
5584,49620,"York-Hanover, PA Metro Area",Bus,2010,84,50,134,0,
5585,49620,"York-Hanover, PA Metro Area",Bus,2011,167,204,371,0,
5586,49620,"York-Hanover, PA Metro Area",Bus,2012,128,785,913,0,
5587,49620,"York-Hanover, PA Metro Area",Bus,2013,113,831,944,0,
5588,49620,"York-Hanover, PA Metro Area",Bus,2014,98,728,826,0,
5589,49620,"York-Hanover, PA Metro Area",Bus,2015,42,270,312,0,
5590,49620,"York-Hanover, PA Metro Area",Bus,2016,35,376,411,0,
5591,49620,"York-Hanover, PA Metro Area",Bus,2017,16,818,834,0,
5592,49620,"York-Hanover, PA Metro Area",Bus,2018,9,535,544,0,
5593,49660,"Youngstown-Warren-Boardman, OH-PA Metro Area",Bus,2002,20,11,31,0,
5594,49660,"Youngstown-Warren-Boardman, OH-PA Metro Area",Bus,2003,20,51,71,0,
5595,49660,"Youngstown-Warren-Boardman, OH-PA Metro Area",Bus,2004,50,24,74,0,
5596,49660,"Youngstown-Warren-Boardman, OH-PA Metro Area",Bus,2005,69,33,102,0,
5597,49660,"Youngstown-Warren-Boardman, OH-PA Metro Area",Bus,2006,66,14,80,0,
5598,49660,"Youngstown-Warren-Boardman, OH-PA Metro Area",Bus,2007,61,11,72,0,
5599,49660,"Youngstown-Warren-Boardman, OH-PA Metro Area",Bus,2008,34,16,50,0,
5600,49660,"Youngstown-Warren-Boardman, OH-PA Metro Area",Bus,2009,55,20,75,0,
5601,49660,"Youngstown-Warren-Boardman, OH-PA Metro Area",Bus,2010,78,15,93,0,
5602,49660,"Youngstown-Warren-Boardman, OH-PA Metro Area",Bus,2011,40,20,60,0,
5603,49660,"Youngstown-Warren-Boardman, OH-PA Metro Area",Bus,2012,54,24,78,0,
5604,49660,"Youngstown-Warren-Boardman, OH-PA Metro Area",Bus,2013,53,43,96,0,
5605,49660,"Youngstown-Warren-Boardman, OH-PA Metro Area",Bus,2014,44,30,74,0,
5606,49660,"Youngstown-Warren-Boardman, OH-PA Metro Area",Bus,2015,50,23,73,0,
5607,49660,"Youngstown-Warren-Boardman, OH-PA Metro Area",Bus,2016,27,19,46,0,
5608,49660,"Youngstown-Warren-Boardman, OH-PA Metro Area",Bus,2017,30,16,46,0,
5609,49660,"Youngstown-Warren-Boardman, OH-PA Metro Area",Bus,2018,21,14,35,0,
5610,49700,"Yuba City, CA Metro Area",Bus,2002,0,0,0,0,
5611,49700,"Yuba City, CA Metro Area",Bus,2003,0,0,0,0,
5612,49700,"Yuba City, CA Metro Area",Bus,2004,0,0,0,0,
5613,49700,"Yuba City, CA Metro Area",Bus,2005,0,0,0,0,
5614,49700,"Yuba City, CA Metro Area",Bus,2006,0,0,0,0,
5615,49700,"Yuba City, CA Metro Area",Bus,2007,0,0,0,0,
5616,49700,"Yuba City, CA Metro Area",Bus,2008,0,0,0,0,
5617,49700,"Yuba City, CA Metro Area",Bus,2009,21,7,28,0,
5618,49700,"Yuba City, CA Metro Area",Bus,2010,53,24,77,0,
5619,49700,"Yuba City, CA Metro Area",Bus,2011,28,6,34,0,
5620,49700,"Yuba City, CA Metro Area",Bus,2012,60,32,92,0,
5621,49700,"Yuba City, CA Metro Area",Bus,2013,59,19,78,0,
5622,49700,"Yuba City, CA Metro Area",Bus,2014,2,67,69,0,
5623,49700,"Yuba City, CA Metro Area",Bus,2015,38,5,43,0,
5624,49700,"Yuba City, CA Metro Area",Bus,2016,48,5,53,0,
5625,49700,"Yuba City, CA Metro Area",Bus,2017,60,16,76,0,
5626,49700,"Yuba City, CA Metro Area",Bus,2018,60,21,81,0,
5627,49740,"Yuma, AZ Metro Area",Bus,2002,0,0,0,0,
5628,49740,"Yuma, AZ Metro Area",Bus,2003,0,0,0,0,
5629,49740,"Yuma, AZ Metro Area",Bus,2004,0,0,0,0,
5630,49740,"Yuma, AZ Metro Area",Bus,2005,0,0,0,0,
5631,49740,"Yuma, AZ Metro Area",Bus,2006,0,0,0,0,
5632,49740,"Yuma, AZ Metro Area",Bus,2007,0,0,0,0,
5633,49740,"Yuma, AZ Metro Area",Bus,2008,0,0,0,0,
5634,49740,"Yuma, AZ Metro Area",Bus,2009,185,3,188,0,
5635,49740,"Yuma, AZ Metro Area",Bus,2010,157,2,159,0,
5636,49740,"Yuma, AZ Metro Area",Bus,2011,134,75,209,0,
5637,49740,"Yuma, AZ Metro Area",Bus,2012,143,202,345,0,
5638,49740,"Yuma, AZ Metro Area",Bus,2013,48,67,115,0,
5639,49740,"Yuma, AZ Metro Area",Bus,2014,29,39,68,0,
5640,49740,"Yuma, AZ Metro Area",Bus,2015,30,248,278,0,
5641,49740,"Yuma, AZ Metro Area",Bus,2016,107,283,390,0,
5642,49740,"Yuma, AZ Metro Area",Bus,2017,147,50,197,0,
5643,49740,"Yuma, AZ Metro Area",Bus,2018,133,36,169,0,
816,,,Bus,2002,0,0,0,0,
1513,,,Bus,2002,0,0,0,0,
1547,,,Bus,2002,0,0,0,0,
2652,,,Bus,2002,0,0,0,0,
5219,,,Bus,2002,1173,2622,3795,0,
817,,,Bus,2003,0,0,0,0,
1514,,,Bus,2003,0,0,0,0,
1548,,,Bus,2003,0,0,0,0,
2653,,,Bus,2003,0,0,0,0,
5220,,,Bus,2003,1715,2739,4454,0,
818,,,Bus,2004,0,0,0,0,
1515,,,Bus,2004,0,0,0,0,
1549,,,Bus,2004,0,0,0,0,
2654,,,Bus,2004,0,0,0,0,
5221,,,Bus,2004,1911,2434,4345,0,
819,,,Bus,2005,0,0,0,0,
1516,,,Bus,2005,0,0,0,0,
1550,,,Bus,2005,0,0,0,0,
2655,,,Bus,2005,0,0,0,0,
5222,,,Bus,2005,1526,2598,4124,0,
820,,,Bus,2006,0,0,0,0,
1517,,,Bus,2006,0,0,0,0,
1551,,,Bus,2006,0,0,0,0,
2656,,,Bus,2006,0,0,0,0,
5223,,,Bus,2006,0,0,0,0,
821,,,Bus,2007,0,0,0,0,
1518,,,Bus,2007,0,0,0,0,
1552,,,Bus,2007,0,0,0,0,
2657,,,Bus,2007,0,0,0,0,
5224,,,Bus,2007,0,0,0,0,
822,,,Bus,2008,0,0,0,0,
1519,,,Bus,2008,0,0,0,0,
1553,,,Bus,2008,0,0,0,0,
2658,,,Bus,2008,0,0,0,0,
5225,,,Bus,2008,3053,3040,6093,0,
823,,,Bus,2009,0,0,0,0,
1520,,,Bus,2009,0,0,0,0,
1554,,,Bus,2009,69,0,69,0,
2659,,,Bus,2009,238,188,426,0,
5226,,,Bus,2009,3776,3804,7580,0,
824,,,Bus,2010,0,0,0,0,
1521,,,Bus,2010,0,0,0,0,
1555,,,Bus,2010,73,0,73,0,
2660,,,Bus,2010,165,56,221,0,
5227,,,Bus,2010,3036,4581,7617,0,
825,,,Bus,2011,0,0,0,0,
1522,,,Bus,2011,0,0,0,0,
1556,,,Bus,2011,0,0,0,0,
2661,,,Bus,2011,179,49,228,0,
5228,,,Bus,2011,2478,5041,7519,0,
826,,,Bus,2012,46,7,53,0,
1523,,,Bus,2012,0,0,0,0,
1557,,,Bus,2012,0,0,0,0,
2662,,,Bus,2012,180,112,292,0,
5229,,,Bus,2012,2106,5056,7162,0,
827,,,Bus,2013,50,5,55,0,
1524,,,Bus,2013,0,0,0,0,
1558,,,Bus,2013,0,0,0,0,
2663,,,Bus,2013,101,59,160,0,
5230,,,Bus,2013,1957,4823,6780,0,
828,,,Bus,2014,70,27,97,0,
1525,,,Bus,2014,0,0,0,0,
1559,,,Bus,2014,0,0,0,0,
2664,,,Bus,2014,90,73,163,0,
5231,,,Bus,2014,1814,5052,6866,0,
829,,,Bus,2015,104,17,121,0,
1526,,,Bus,2015,0,0,0,0,
1560,,,Bus,2015,0,0,0,0,
2665,,,Bus,2015,134,55,189,0,
5232,,,Bus,2015,1688,4834,6522,0,
830,,,Bus,2016,63,9,72,0,
1527,,,Bus,2016,0,0,0,0,
1561,,,Bus,2016,0,0,0,0,
2666,,,Bus,2016,128,53,181,0,
5233,,,Bus,2016,2017,4844,6861,0,
831,,,Bus,2017,58,17,75,0,
1528,,,Bus,2017,0,0,0,0,
1562,,,Bus,2017,0,0,0,0,
2667,,,Bus,2017,292,39,331,0,
5234,,,Bus,2017,2272,3659,5931,0,
832,,,Bus,2018,63,9,72,0,
1529,,,Bus,2018,0,0,0,0,
1563,,,Bus,2018,0,0,0,0,
2668,,,Bus,2018,325,35,360,0,
5235,,,Bus,2018,2258,3328,5586,0,
